10011110100000001100000000000100110100000001001000100000000000001011100000100100000110111110001101110
00001010010010011000001000110000010110000010001001010110011000000010111000000100101000111010010000100
00100000000100100011000010100010100100001000110100011110011011001000001010001110000001001000000011001
00101000000000001100000000100010010000111000110000101100100000001000000000101100010001100000000001000
11000010100001101000101010000111110000000110000001000000001110010011000001001000100100000000000100000
00000001111000000000101011001111110000000000110100010100001000010000101000100100001111001110011000000
10010001101110101000101001001110001001100010000000100000010010000100001000001001001111100000100010000
00000000000100000101010000000111000100001101010000001000000000010110001101000001000111001010000010111
00000011010011000010000101001011000000000100000010100000010001011000100000101101000010000001001001111
10100101100010001011011011000000000000001001000111010000011000110001000001110100010001000100101010111
01010000000000001100110011000101010000101000000010001101111000000000000011110100000000001010000000111
00010000000000000001110011010000000010001010100101011011011100011000000001010001011011100001010100011
01000110001010001010100010011000101001100000011100001000000101100000000001000111111000000101000100111
00000000100000100000010000000000001010000000010000010110011000110110100010010011010010100100001010010
00000001000110000000001010100100001001000000100000000010001110001000000100000010000000000000000000000
00010110010100000010001010100001000000010001100000100011000000110000100001001010100101001110001100010
10110110000011100000101100000000010000100000011001100000011010110010110101111110000000100001000010000
00110000000011000011001000000010100110000000010000000110001000011001110000000000000000100010000001100
10100011000000011011001000001110100001100001101110000000010000101000100101100011000101100000001000000
11110001100000001000000110011001110010000000001100000000000100101001010100001000000000000000100100000
11000100101000011000000010100000110000001100000000111010000001000000000000110001100011100111000101101
10100110100011100010100100000000000000000100100101111100111010001100000100000000000111111010000010011
10100010000111101100010110010100101100100110101111111110010011001000110000000011101001000000110000011
10000011000011100110111001000101100000010001101111111111101100100100001100000001000000100101001001001
10100010000011110110010010000100000111010110001111111111101001000010000000010001110011010000000010000
11110001001001000111000000011000000110011111011111111111000100000001010010100000110100000010000000010
11111011110101000010000101000101100011100100001111011110011000000000000100101000001000100000010010000
11111000010000001110001000001000000011110000100001000000001010110101110000011000100100100100000000100
11110010000000000001011100001000000000011100100000000000010000101100010010111000100011000111000000001
11110010000000001000101100000111011001000001101000000000001100100010001011110011001000100000100001010
11100000010000101000000000001111100000111100010100101000010100000000000000100100000100101000101011100
10100010000001100100100110000011101100100010100010000010100000100010000000010100011100000100000001000
10000101001100010000100000100110001000001100100010000001000010000000010000100011000100000001000001100
00000000001100000100100011000111100000010100000000010100011000101001000000001000000101001000101100100
11000000100101010000000101000110101110100001100010110000001010100110000000000100001000101000010011000
00010010000110001100110000010100000001110000101010000000000011101101101000100010110100101101000000000
00010000010000110010001110101100001001010000000010100010001000001001000000101100010110110000000110000
00100000001110000000111100001101001001000100011001110110001110000101000010101000010100010100001100100
00110100101100000100100100000000000100000000000000100010000000010100000000101100100000011010000011000
00000000011110000101000100100100000100000000000001100010111001001101001001000000001000010000001001101
00000000010101100011100000011100101110101000110000000000000001000000010010001010100000010010101101001
10000010010000000001000100101010011111100111101001000000101000000010110010010001001110001111001000000
00010000001000000011000000000000100111100001000110011101001000010110000000000001000101100010000000000
01100100000000001011010011000001000110000000010000110000000000010000010011010001000000001101001100001
01000001000001010000001100001000000111101000001010000111100100010000101010111101110100100000011000100
01010001000010001010000100001010010010010011010000101000000100000101001000011011100001000000000110100
00000101100100000000010101001101010011001100000100010010000100100010001000010000000000001001101101001
00011001110010001001000010010000000100010001000000000000000000011000000010100010100111100101100000000
01000001101010110000010001110001010111000000111000000101101001001101000001000100000111010000000000010
00100000001000000011100010000100000001010000101110010001001101001100000000010000010110011101010001000
01111000000001001100000001111001110010110000001011101000110011000110001000011001010000111001011010000
01101100000000010001010000001111111010000100101000000110110000101111100010000100010000111000001000010
11000011010001000000110011000000111010010111000010011110001000011000111111000000100001001101000000010
00011111000011000000110111110101111000010011100110011100010000000011111111100101000101100100101110100
00000000100000000000100011110000110000001000010000010010011010001000101111110010000010000100011111100
01010110010011010000101010001100000010001010000110000000001011010010101001100000110000110000001100000
10100011001011001001100010100110010001111100100000010100011110000000101001101000010010000011000010000
10000010010000000000000010100110000011111000001001001110101001110101000000010111001010011000000100110
11010110010011000000110000001010101000010000001101100111000100000011001000010011010001010000001110100
00100000001000010001000110101000000000001100010111101101000001010111000000000000000000110000001000100
00000111000000011100001110000010010000010001100011010001001010101010000111000010101010010001010000111
00100101001001011010110000101010000001110001001000000000000010000000111110101001000010000001010101110
00000001000010100011110000000000000100000010000011100000011011101000001100000101010000000110100001110
00010100000000001001100111000000000110000000100001100011000000100010000000000000001010000010000110000
10010010011011001101000000100000000010100100101010111000001100000000000010100000001100100000000011011
00000000000100110000001100000110100001001000000100000000010010010000001000000011001110100001100110000
10001001010010010100101110100000111110010010000010001100110000000011101101000011101100100000011100011
11011001111000111001110110000000101101001111001001110001000001000011000000100000110110001011100000111
00000110110000110110100000000000101000100111000100000100000010010000010100001010100001000001100010111
01011000000100010000011000000000000110001100010111010000000011001110111010100001010010000010001010111
00001100110001111001001000001000010000110100111110000000001000001100010000001100000111100000000110011
10000000011111110010011000000100000001100001001000010101000100001000000001001000111110110101101001001
00100111000100001000000010101000100100011100011110001010000000010000000000000010001100000000101001100
01010000000001000001000000010101000010000010111110000001000011000000001010000101000000001100011001000
01000000000000011010000110000010110110110100100110011010100011000000011000000101101000000000001000000
10001100000011100100000001101000001100010001000010011000000000001000000001100000000000010100011110100
01000110000010000001010001000000000000000101000001010101000110010000010000000000000000000010000000010
00000001101010100011011100000111101000101001001001010001100000100100010000100000010111000001001000000
00100011100000100000000010011011100000101010011101001000100000010000010000011110101110010001011000000
00000000001000100000001011000000001010000100111000010000000001000000010111001010000010000010000001001
01000101000000000001000100110000000011100001000000011000000000000011001001000000000011000100001000000
00010001000011101101000000000001000000000110010111100110010101101110000100001000010000010010001001000
00010011100000110010001010100010001000000010100100100000010010010001100000001110100000101101100100010
01000100001010000110000000110010001100010000001000010000100000100001000010000100110100100000010000111
00101000000010100101000000000000110000011000000001100000000001100000001011000110100010100001000000100
01000000110010100000000101010001000011001000000011111000011000100010001000000111010000001001011100000
01001010100100011100000011111101101000000010000001110000100101010010101000000010000000000000100100010
01010010100100000001000000001000101000010000000010100100100000000000000010000000100000111000000100000
00011001010110010001010001110000100010000010000010001100000000100001100011101001100000100010010000010
00100100001001000010010001100100000100110001100000000001010100000110001000110100001011010100110100000
00110000110100110100111100001100000001110011111010010100001010000001001000010100101111001000010100001
00000101100000000001010111110000000011100001001101000100001000001100010000000000110000000001110000111
00001001001000011001000100001100000111110111000000110001101100000001100000000100010000000010000000000
10001001000111000001000000001000000010100100000000010010010001110001100000101101100111001101100000000
00001000000000101010000101101000001010001111000010000010000100000010001011100011010000100000000000000
10100110100001100110011110001000000001100101000110001000000000110100110000110010011011111000100011100
01011111010010101010000000111010010100000001110000010000000000000001110101100000010110100000110000001
00000000001000010000000000000011011101001101110100001100001010001001000001111010100100101001000011100
00110000000010101010001000000001010000100000001000001000000011111100000011111100000001100000010111110
01000101001010100000010000010111000100101110101000000010000001001000101111111000000000100011001111111
01001000010001100110000000000010010001111110010010101010001000001001001111110011001110011000011111111
