00000000011010000000110110011100000111111000000000000010010000000100001000000010000010000001010000101
01001000000000000000000001001110000110010000110000101000000100000000100011110000100011010100000000100
00011010010000000000000010000100000100100000001100001100000100101100000000010000010011010000010000001
00010010011100100000100110000001000001110000000001000100000001000011001001100011001000100100001010100
00000100101100100010010100101000100011100000000110001111010000101010000000110110001100011011000000000
01100101001001101110010011111100100000000000101000100010001010111001001000000011010000000010010000000
00001010000010101110010001100000100111000000010000000100010010111000110010101100000000000000000101100
10010010101110000110110000010110000001100000000000001101000110010011111100101110000000000011000011000
00010111000001000011000100000100011100010001011100001000010001100001010001110100010000000000010111100
01100001100010011011100000011000010011000000001100000010101000110100000001100000010100000001110001110
11000001001111101000010000010001100110100000001101010000001000011000100001110001001000000001110000100
11010010001010001001001000010010000110000011000010000010000000000111000000100001010001010100000010000
11111000001000100110010000010111000000000001101000100000010000100000110010010010000100101101001001110
11111100000000011000000100111001100000100011001110111100000101000001100111110000000101001100100100010
11111111000001100100000000000010001000001111110001010010000001010000001000000110000001000000010000000
11111111100000110000010000000110000101000001100010011000000110000100001001000000100001100010000111100
11111100010000101110001001001001011000100000000100100001000100100000000100000000000000000011000011110
11111110000000101000010100000010000001001100000010100100100000001010100000100000001000101011100010100
11111111001110001100000000010111000000110001000000011010010000000001000110000000010110010010001000000
01111110101011010000011110000010001000011000010110110000000110001000010010000100000001100000000000000
00100000000001000000111000010001001000111110001010000100000100000010011111010000001010100000001000010
10000101000100010110000010011000101001000000100001000001100010000100100011010100100000100010011000100
11110011101110000000011010000110110000000010010010010000000000001100001111110001000011000001100011100
11100011001000000000100000100100010000000001001111000000011000001000100011110100000000001000000100000
10010100000010011100101110000100001101010000110000000000111000100000010001110001011010100000000100010
10000001000011101100001001000000011000010100101010000100010000111101110000111001100101110111000000101
11100000010000100000000000000000110101101100000010000000000100000001010101111001010001111001000000000
01000011001100010000100110001000010000100000010100000111011111000100010110000100000001100010100001010
00101010000100000100010001000010000000100100100000110000011011010000000101010001000001101000000100000
00110001000000001100000000000000101000001001000110100010000000100000110000010000100010001110010000000
00100000000101110110101000001000000010100011101000010110101001000010100100000110000100100010110001100
10000000000000000000000100100000010010111000001000001000110011101010010010001010000000000000000100001
00001000100101000000001000010010111011001000100100000101111111101010000000000010011001000000010011000
00110110100000100101000110010100001000010000010000101101000001100011011010110010111100001001000001001
10000000101001001100001000110110100100101000110000010010000000111011100011000011110000001000110100100
11000010101100100001000100100001101000000011101000001001100100000000011011001100110100011000000011111
00010000001100010000000010001000100110000000001000000000001000110101001010010010100000000000110000101
01010001001000001001110010010010101110000111000100000000011100010001001000000100000100100110000001000
00010010001100100000111101011100000101001010101111000000111000000100001100100001001110011110100000000
10010100100000000110011100010001000001001010001000010000010000000000001000001111100001010100000110000
11101010001000010010111100111100000000001000100001000100100100000000001101000001110100000011010000001
11000000000000100000010010000110000100000000001100000011101000100001001100101100100110000010001010000
11101100100101110110000000000110100100010011110010000010001000101000000100010010010111101000001000101
11100000000001001000011110000110010000010001100000000001100010001000100100010001110000110000000010101
11110001001100010001000010000110000001000101000010000000000000110000100000001000100000001000001001001
11111011000000101000001101001100000110010000100001000010000110111101100000001000010001000000100011111
11110100111011101000100000001000100000100010101111000100010010110010001000000100001000000010000001011
11110000100011001000011000001000100000111000011000000111110100110000010111001101110001010100110110010
00000000000010000000001010001010100000000100101000001100000010000110010000100000100010000100011000000
00000001000010100010001000001110000001000010000110010000000100010001100101001000010100000000000000001
00100010011000100001000111000001000001000000000101000001100001100100000000001111110001000110000101111
00000000001010001100100100001010010011101000001100010000000000000010101001101100100000101000001000101
01101101101000001010011101000101000001000001000010010110011000000001100011100110011000101100111101000
01111011110010000000001000100000110000000000000111101000001010001000000010101100010001100000001000011
00001001110100100001101010010000000011000000001010000001100001100101011110001001100001000100100000011
10000001100010101100000010100100100100000000001000010000000110000000010000111010001000000000010010000
00010011000000011011011000100010010000000110110000100110010010100000001011100001001000000010110001000
01000000100101000010011000100000000010100000011000001000001100100000000000101000011000000010000000011
00100110000001010000000010001100001100001001101000000111100101100101001001000100001000011000000011000
01101010000000010010010110000100010010000011000000011001000110000101110000100011000000010000010000101
00100001010000001000000000110000100000000111000101000000001000001110001101000000010101000001000010100
10110100001100011110110100001100000110001111001111101000000100001000001011101000011000010011101000000
11001000100000011100100000000001001111011110000110000100010010000110110000000000110000100111101011100
10000010011100001100000100001000000110111101100000100001001010100100001001100010000000111111000010001
01100001011111101000100000001001010010010000010001011000000000000100110101011001000000000000100011100
00000110000111110010100000010000000000000000011000000000100001110010010000000011001000000010000111010
10011111011111100111010100100011010000000001110000100000000101000000000101001000101000001110100010001
00111110111111110001001110010000110001000010110000100101001001100000011001000011000100001000000000011
11111110011111100000011101100001010000100000000001110100000011011100001001001010010101111001011001100
11111100001111011000111000100000000001000010010000110000001000000110001010000100110010000101110001000
11111100010011000000010011000000010100010010000000000000010000000110000001101011001010011111101001000
11100010000001000000000000000011000000000001000000001001010111001001000001011001101000111100000000100
11011000100000011010001001001001110000000101100010101110100001000000000000010000101000001011111000000
10001010100011001010000010100001010000010001100100000010111001000000100111110101001001000010000000000
00000000010000000000000110101000000110010001011010001100110000111111000000000000001011000001010100100
01000000001000100101100010010000100001001001001000000100000001011110000011001001101000010100100110010
10000001111110010100010011000010100000100001101100110000010000000111000000000000001010000000000001100
10100010001000001000110010001000010000010111101010000010001010000111000001000000100000001000001000100
00001010011100010100000000101010000100001011000000001010000100010011001001000000101110111001000000001
01010000001000000000010000100001001111110000010110010000000001000000010000001101000111000010000001100
00000000101000000000000000011000101111000001100001010000000100010000111001010110110010000011000110000
00100000000000000000110000100100101110101010001000010010000001000001110101100100100000001010000010101
00000000100000000000001000100010011100100111000000010000110000001011100101010000010000010000000000010
10001000010010000010000101111000001110100011101100000000000000000000101000010010110010000110100000100
11000100000000000100000001100101100100010011110100000000010000001101100001000000001001010000001000010
11000101000111010000100000001101000001000110100100001011000001111101100000001101000010001010010110000
11000101100000000000010101000011110000000000000010010001000000111011110010100101000000001111010010101
00101000101001101111000100100001010010011010010010101000100000010001000111100110001000100111000010000
00011110011110010000000101001100001000000010100000001110001011000100001111000111010001001110000010100
00000000001000000101000000100001011000001101100100001110101011110010001111000011001100000100111000011
00000100000000010100001000001001000100000000010010100111001000010001011111100010001101100011000100000
00000100000000000000000001010000010000010010101111011110000010110001111111100000000000000010011000000
01100101000101000001000010100000000001010010100001000111000000100011111111111110000010000000110101001
00001000100010010001101000001000100010001110000010000010010010000001011111111001000100011100010010011
10100001000110110101110000101001100110101000010000010000000110010001001111111010110100010001001000111
00000100010000000000100001011100110000001010010010011000001010000100011111100000001111000100100100011
00000001110000000001110111001010000110000110100000100111001000001100011111110100000010001100000010001
00000000110001110000100000011000001111000001000001000111001010000001000000010010111100000101000000100
10001100110100010000001000001110000110010101101000000010000000011101000110001000010001000000011000001
11001100011101001000001010011110001000001000000001011001000010001000000100000001110011000001010011001
10001000000001000001000110111111101011001001000010010010000000000011001001100111100000000010010111100
