01000001000010001100000011111110001100000001010001001000000100000000100001101000010000011001000101000
00000101000000000010000111110100000000100001010100010010001111100111000001000011100100100011000000000
00110010010011110010100011000001110000000001000000001001100001000000100000001001010110010111100000100
01110100000010100000100010011101000010001100000101000000000110010001100001110001000000100010111011101
01011000011000100100000010010000000100010000000100010111001100101001000011010111001010000000100001111
00001001001001010000010000100011000010010010000110010001000010000010000010010010000000001000000100111
00000000010010000000110001100001000000001100010000000111000010010000101100010100000100011001001000011
01000010001000100010001101100000000100001100000001000001100111100000000000000010000100001000001000000
00010110010000101000000000011101100000011110100001010010111111000001001110100001001000001010100001100
00010000110100110000110000100100110010111110010001010010000111111010001001100000000100100000000000001
10001000010100001000000010001000010000011101000000000000100000101001111000010001001110100001100010100
01001110001001001001010100100000100100100000000100111000111110000110000011001010011000100010011011011
01000001000000000001000111100000001100010110001101111100011100000010001011010010000101001000000100000
00000101001000001000000000000001001100110001110011100010011110101100011110010000010000100010100000000
01000011100010000100111001000010110110000010000001110000110100000001110110111001110001100001000100011
00000000001001000010001000001000000011100110010001111000000011000100010001000100010001010010010000010
00001000000101000000010001000010010000010000010000110000001111011010000010000001001010010111010010000
00001000100010010001100001100000000001100010011010011000010000000000100000001000000010000000110000000
00100011100000001000000011110001001000010000000001000101010000001000000110000110100010001010010001110
00111100000000000100010011111000111000000001001000100100100100110001011011100100010000000111001000100
00000000101001011001101101100101000011100010000001100100001000000001010001111000111010011010011000000
01001010011001001001001101100000000001111111000101000100000000000100100101100100100000100000110000100
00101000011111001010010000000001000101110000001100111110000000100011000100001000001100001000110001110
00111011001100110010000000000000010110100000000100110111001100010000000001000101000001111000000101000
01100100000000000010100100010000110010011111010000010001010110100000100111001011000000010101001000100
01000001011010101001000000000101100000000000000010000100000110011001000101011000101010110010001010101
11100000110000100000010111000000000011110110000110001000110110011010100000000110000010001001101000011
00100110100000101100011111010000000000001111001000010111000000010000001001000000000000001001010011011
01000000111010100101011111110000000110000110011000100011000000110010000000011100011000001000000000001
01100010011100110000011110000100001010000100011101001100100100000000000000010100001001100110000000100
00010100111100000001001001001010111000010110001100000001110000010100101000000001000110000000000001000
00011001010110100000010000001001000000000110101000100001101100100000100100010000100000010110000110010
10001111000100011000101000001100000010000001111010010000000000111110110010100010000100000101001100111
11001110011010100000000000011000000000000100100101000010110110010000010000010001110000000001001100001
10101001000000000000000110111000001001000001010101010100110001010010100001001100000100000011100001100
00000000000011000010000000000100011000110000000001100110010010110001100100000000010010110000101001111
00100001000111000110000010011000001000001000000110000111011000100010001100100010010000000100100001111
00001000111001100011110000010100100000000000101010001000000000000010000110000101000010000111010100111
00000000000010010000000000100110000000000000101010100100000100011001001100000001010100000010000001111
00000001001100000000111000100110010100101100001000100100001110011001000000010100000100000001010001111
10110000100100010100001111000000110001110101111100010001100100000000000001100100001110001010100111111
00010000000000010000101101010100100011100011111100110100101000011110010101100011000010110000010011111
01101100101000011001010001000000000001100001111000000100001101000011001011100000100001100111001011111
00100000000101010100000000000000000000011000110101000000000000010100000000110000000100001110000111111
10100000001001000000000000000100010000001001010010000000000100011010010000001000000000001110101111111
00011000011100100000001100100110010110100000000110001001100110000000000010100110000001001011001011111
10010000100010100101010100011110000001000010101100000000110010000010100010101011101001110011000001111
10100110100100100000000000001100000010000010000100000100100010110010101010000000010001111000001100010
00000000000000001111001000110000000001010000000001010100011010010110100111000000001000111110000100000
11001001000000001010001000000101000011010000001010000101111100010010000110000110011100011010001100011
00000010001100010000001100000000000100000111111000001000000100000111001110010000011010110000010100101
00010100100111000001000000100001000101000000000011000110110000011111101001000001000010000100000110000
00011000010100000011000101000100010100010000101001100000100010001011101010000000011110000000000000000
11001010111001000000101010010010000000000000110100001101001001000001111000000000001001010010000110010
11100001011110000100100010000111100011000000000100000110000100100010000100000101000001001001000110011
11110001000000001010101000101110011101010110001100010001001000000000000000100100110000110001100111100
11111001010010101000000111000100010000111001010100000000101000100011010100110000000100001101000000000
11110100000111000010100000000001000011110000010000100110000100000100011101000100000001000000000000000
11110000001110000000000011100100001111100101010000100000000101100110010100100100001001000000001000010
10001000100000010000000111010100001111010000101100101100001011110001000100000101000100000000000000100
00000100100100000000000111000111100111000100101110111001001011100100000110000001000010000000010000000
00010010001000010000100010011000010110000001001111000011101001101001001000000000000110000110011000110
11101000000001011000001100000101000100000001001010001001000001101000100100011010000000101110000100011
01000011000101000001010100000100010100000101000011010010001100011110000010000000000001100010111000111
01100001100001100100010010000010001001000001010010010000100000001110000101000100011110001001100000111
00000110000100101001010001100100010001100010000000000000110010000010000001100100000000000010000101111
00010111000100000110000101000101000110000010001001000010110001100010100000000100010011110011011101111
00100101011001000001000010100010000011001000100011000000001000100010001000000000001011000100000001111
01000000010100001100001000001000001001010000100110000010110110100010000000110100001111000000000101111
11100000100100100001000001001010000000010001111100010000000001000010000000100101000010100000101000111
11101010100100010111010000000011000100000000100010000100010100010000101000110100100100100100010000011
10000100000000100100000101110100011000101101100100000100010001100001000000000000000001110000010000000
01100100100000000000010000000001100000011111100011000010110011100011000001100011000011110100100101100
01110010100000100000000000100010001101001101000011100100100001100000101000101001000101100111000101010
00000100000000000010000000100100100100000000101000000011110001011001110000010000111100101000011100000
00100101000100100010001011001010010000100000100011001001001101000010100000010110001000100001110000001
00000001110110100101111011101000000100001010000000000100000000010010001100000100010000000101100001011
10001011110011010000111001111101111000000101010000000100011010001000010010000000100000001011000010001
01010100000011010001001101010100000010000101100010011100000001100000000001100100001001101010010011110
00100010100001010010000000000000010000001100001100011001100010101000001111001101000010000000010100000
00010001101100000000011010000000000000000000000000000000001000010100100101111100010011010011000100110
01010011100000110001001001000100010000100010010000010100000100000000001100111100101001000010010001000
10000001010000101000010011011000100010100101000000100000001100001001001100001010000010000001010011110
11100101000000000101011100010000001001100000000100100100000000111000000000000010100010110011100011101
10100100010101101000010110011100011100000100010100101100000001110001100101010000000000000000100011000
00000100010011110001100110011110011010000101001110011100100101100001110000011000000001000010000001010
00000100000001100000001000001000000000010011011110011101101000100000100010010000000011101110100000000
01100000110110000101111000010001010100001000001100101001001000010010000100000001011101000110010011000
00001001110001001110111011100000000100111001011000100000000010000100100110110000100000000100000010100
00000000000010001100000011100000001000011111000000100110110001100011000001001111101000001001100010010
01010010000001010000000000011010001101001000100010010001101010000011000101010001011000010001001001011
00000000000010011100001000001001010001000110011001101000000110000100000101000000000000110010100011001
00001011101000000010111010100001000101001110001101000010000000000011000010111000110010001000000000100
00001000011111001111101110000100000000000100100100001000000000101000000110100000011010010010100000000
11100101101000000001000000010000001000001101110001100000000010000000100000010001001000110000001000100
11000110100010100010000001000010111010000000110001000011100000010001001100100000011000100101000110000
10100110100000001000000010001100000100110011000100011000000000000010001010000000000001000010000110000
00100000100010001100001000110101001111001011100010001100000010010100000010100000100000010101000100000
00000001010001100100100101110101010000000001001101000000100010100000000000110000010000000000100100000
11000010000011100000000100000100111011011000101000110100000100000000000010000011100100000010000110001
00001001001000010011001101010000110010000001111100000000010010000000000001000111110000100011100000111
