11110000000000010101000000001001110100100000000011011010010000000111100000100000000000100000111111000
11000100100010000000000000000010100110010101101000001000000011110111101000000001100111000110011100001
10001011000001001000100010000000010001000000010000000010110001001011000000000000100111110010100000000
00000000000001000101110101101011100001001011000000000101010100011000101000001100001111100010100001000
00010000001010000000000001000001000101000100000110101000011110010000100011000000000101000100010001011
00000010101010001100111000001100000010000010000000011010001111100101111011000010000000000000100101000
00010010101101001000000000101100100110001000110000100010100110000100100001000001000000010010111001000
01000010011100101010110000011000000001000000000000000110000100010000010000001101110101001100000010001
00000100001100000000001000000101000011001000011000010000000010011010100111001000010100001010001011011
00101001000000101100000010000100100010001001000000000101010010100000000000000010001110000000000111111
11000100001100000000111000010000110101000000000010001011000000001101001001100010111110001010100011111
10000010100000000010101100110111000101100000000000001000100010011000110100000100000111011100000001111
00100110001100111001000010001010000000001001000110000010001001000000000000100110010110110100000011111
00001000110011111100000001000010101100100001000010000001100000010010000100000111000000100010100011111
11110100000001100001000011010010101000001011000000000110000110100011000100010110001001110010001111111
11110101011101110110000110010011000000100000101000001000101000000100010010000001110111000010111111110
01010000111000110001100000010010000011100111000100000001110100101011111000001001000011100100111111110
00000100000001000100110100001111011001000100010001100001100001111000110100000010000011001110000111110
11000000101010100010000100110110011000001110101100010101101000010100000000000000101000101110100001010
10011000100010001000010011000001000000010100000010000110000000100110000001101011100001001111000100000
00010110100110000100000000100000000000100010011000100001000101101000110001010000000000011011110101000
00110100000000001100000000000110100000010000100111100000100100000110100001010000010100000001110001011
01000000010010010001010000110000001100000100000001000010101101010110000111000101000001010001101010001
11010100000000000100000110110000100111100000100100000010001000100100000000101001000001110001000001001
11100000000100110000100101000001100001101000010000001000001001101011010010000110110100011000000001000
00100100101101000010000100000000000111110000110000111001011001000011111100001000110100110011010100001
00101001000100000110001000011110000011000000101001010111110001001000111111000010000100010100010001000
01000100000001011000100001010001001010110000000000000001000001010000011111001100111001000000011001100
01000000000111001010100000000100001000100010100000110101000000010100011110111000010001000110000110010
00100100000000100110001110001000001011100010010110000101010100000001001110000000011001000010001000010
01100000000001000101001101011011101010000011100000000000100001000100001000001001100001000000100010000
00100100100000100000010001000101011001010001110100101000001010000101001110000011100000000100000110010
00000100000000100110011000000001000000010000100110000001000000110001101000110100001111100000001000000
10010000100000000110000100000000101010100000011110000100000000000000010001111111010111000100000001000
00000110000010110100000100010000001001010111000000000000100100001000011000010001010010010000101000111
10000000110000100100100000110100100000000000001001001000001000000111010001001000001000000001000000100
00100000000100000000010000010000000100001011000000100011000001000100011001000010111110101011100100000
01111000010000100000100000000100001010100000000000110000000100000100011001100000011111000000010101000
00000000100100010011101000000110001001011000010110000001000100000000010100111010001100000101011001000
00100010000100000010000100001000001001000000000011000100100000000000010000010001100010010010011001010
00100110001000001000000000000000100001000000000001000010000101100010000011001001000001111000110010110
00001001100000000011000010000010100000000010010100000010000100000000100000000001100000010010010000000
01010000000010010000000000111001111110000100011010001010100001100010100100111100101010000000000000000
11100000110000010000001110011100001000000000000000101010111000001010010000000100000000000100100000000
11010110010011001101000111100001000000010010100010100000000010001100111001010100000000000010001001100
11000010010000011110011000011010001110000000101000111010100000010010000000011100011011011001001000110
11001001001010111110000000001000101110000111000101000000010100110000100010100000000000000110000100000
11001000001000011000011011010010011111100110000000000100101000000000001011011011010100011011001101010
11111010100000000000101100011100011111110000000000001000000100001100110000010001010000100000000010011
11100100110000010000001001001010000011110000010001101100010100100010111010000001101100100010010000000
11100000100000000000011001001001000011110000000000100100000000000101010000000001001010000010110000000
10110001000001010010001110001001000101000101000011000000011100100000011010101000000000000111110000100
00100110110001010000001111001000000000000011100000001111010101000010010000100110010001000111000000001
10100110100001110000111110000001000001100111110010100001000000000011101010110010011010001010011001111
00111000011010100001101101100000100011100000111010010010000001000010101001001000101010001000110000001
10011001100000101000000000000101101011001010010011100010001001000000001000101100100111010100100101000
00100001000000000100010011001101110000111100001011001100000011000101001000000000101111100101000111110
00110010110010100000000011000000000000111100001000100100000000000110111000000001001111110000011011111
10000000100001100100111000010001001010011111100011100101000000001100001110000010000101100000000011111
01111010010010111000010000010010010001111110001000011110000001010000100010000000100000001000011011111
00000000110010011000001011000100100110001111110100000100000010110011000000010101100101000011001111111
00100011110100110001010001000000000000010111000000010000000110100000001000000100000100010001111111111
01000100100000011001100010000000000000000100010000000001111110011100000100000001101010110011111111111
11100010000000000000100111000001000111011000101000101110111110001100100100010000100000000111000011110
11111001100111010001100010010010001111110000101000101000111100100011010010011110111000010000100010110
11110000010100010010000000000100001111010100001000000011011000000100000000010000111000010000010000000
01100001010100011011010000000110011100010000100011001010000000001110110000000100110111000011100010000
00100100010110000000000101010000101000001101100011101101001000100100000000100010000011000100010110110
10010100000100010100011000001010100010000100011001000000010000000000010000001000000000000101010001100
00010101001100100001110000100000100100101101000000110110001100000100000000000000001000000000001011001
10000100011001000100110000001010011101110000000110001100110000000110000011000111111101001101110000001
00101000110000000000011000011001001001000100001101000010111000101000010110010111100011100000110000100
01111010000011000100001100000100110000011000101100000000000100010000000010100111000011001010011000100
10100000010010000010000000001001000000001010001001000100000001000000000001000001010000100000001101100
00000000100100110000000011000101011000010010010000100010001000000001010001000001101000000100010000010
01000001110110100101000000100000100000000110000010100010000000000001111111011000000001010000001000011
00000001100001001000000110100000010010000000000011010000101011000001011110000001010110110100100010100
01001000111010000001001110000000110001001011000010000001000000001000001001001100000000001010110100000
01001000011000000100010000100001000001000000001000000001000000000010000011010000111000100010000011101
01001001000001110001000001100001001000011000001010001010000101101000101011101100100010100000100010000
11100000011000000000010011000011100000001111000010100010110010000000000010101110010000110101100000010
11110101001000000010000111101101001010000000001010000001101000010001011000000001000000000001000100001
11100010000011000001101011111101000100100010100000000001001000000010000001010110010101100010000000010
11101001000000100101010011101000011110001110101000011000000101010001110001100000000110000010000100000
11000110011001101100010011000000000001101001000111101010110100110100111000001001010000010000010100001
10010010000000000000000000110010000000010000111001000101110000010000101001100000100100000100001010011
00011010001010111000010000000000101100010111100000000000100100110001000000101100010101010110010001111
01100000110000000000001001000010100000000000000110000110100000000001011100001000110000011111001000011
01100100000001001000010001011111000010110001000001000000000110001001100000110000001000100111011110011
10000110100010000000000110001111000000001010000100011000111000000000100001011000000101000010110000100
00000110001001111000000000001110100100000000000010111100000100011110010010000000101000000000000001000
00010001000111001010110010101100101100100010111010111111110110111000111101111000001001000000110000101
00010010001110000000000000101101000011001100000100011110000000011100110101100101000000100010101100001
10000000000000111000011101001101001000000000010000001110001010011000100100000010100000111010000000001
00010000000001001010100000000000111101010000011001000110010001000111001101001000101010100000000100101
00010111101001000000000000100000000010010101011000011111000000111100011000000000000100010000100000010
01000000110000101000111110100000100111010010000100000110000011000110000000001010011001100001000000000
00001100010100011100111111000011100011100000000101011000010001101100100110100011001001100000110000000
00110000000111011100111101010000000001010100000000100001000000001000000010010000000100100100000000011
00000000000101001001111100001011000000010010001000000110111101000000100001011010000001000000000000000
01100000010000001100111000000000111100010000110000010000111110011101100110000010001000000000000101000
