00011110000000000110011000001010101100001000000001000110100100100000111100001100001101000011100001000
10101001101100110010000000000000100000011101110100000000010000000000001001011001000100010100010000010
10000001100000001000010001100000001000010000110110110011100101000010000010111000010001101001100001000
00100011100000000000010001000100010000100010000100001010011111000001110100100001001011100001101000000
01110001000000110100011010010000100000000000001000000000001100000001100000000010000000000001000000011
00001001100000001000100011001101001111000001100000011000010000010000101001010110010101000000010010001
01111011110010110101100000010100100001100000000000010011011001000000010001001110010000010100010000011
11111000000010010100000100100000011110100111001000010000001000010010010001000000001000000100100000001
11000001011001000100010000000011100010100000110111011110000000110010011010000001011000011110010000000
10000001110001100100100000001001000010101110100100001000101000011000000100011000001100111001011000100
10100001010001100001111110010010110000100010000000000100010000110001000010101100010010011100011110000
11101011010111000000011100010000010000000000000010000101010000010101111010000000001000001100111100100
10000110011001001101011110000010000100101001010000000100010100010001110000001010001000010011011010110
00001001000000110000011100000000110000100011110110000010000110000000000011001000010110001010000010000
10010000000000000100001000000001010110010001111001110000110001010110000000000100000001000000000000010
01010110110000110000011110100000001010001000110011000100011100000000011000000100110011011111101000100
01100000000000011011101111001100111001110000100000001100000010110001000111100100000000010101000100101
00010000001001111010000100001000000010000000010100100000011010000000000011110000110000010000000000010
11001000010000010100010000010100010000000000101110000001010010010010000000001101100000101100010000000
00010001010000100010000000000100100011100000000101000000001001000110001100000110110111100001010000001
00000011000110010100010101000010000111000010101000000010001010010000000000010100001100100010000011010
00110110000010100000011100000110000011000001001001000100000001000101000000110001000000100000000001000
00000010010001001010000100000100000101000111010000000001000000000100100010010011100010001000000000110
10100000000100000000000101000001000000111100000000000010000110111110000000011001000001001110101100100
10101111000001000100011100011000000010101001011001000000011010100100001110000000111001100000110001000
11000001011100000001100001000100000010000010011010010111001010001000100000000010000000000010000000101
11100000000000000111110000000000111000000000000111010000000011000010101010110110001010001001111000000
00000010100011000011100000100001111001001000101111000000010101100111100000000110001000011000000101010
00010100101011011000000110000001110001001001110110000100010100000010000000111000100001010001000001010
11101100101011001111001000100110100110001000100000000001001100000110010000000010110100011000000000000
00000100100000001010000100010000000111000000010100001100100100000011110000100110100000100001000000000
11000000010001001001011110000001100010010001100001000000010010100000000001111000010000000100001110111
00111010110000010100010100001100010111000010100000000100100100101010000000111111000010100010001000100
00000011010010100000010011010010000001100100000000000100100100000010100000111111000110000101110001010
01101000000000010011000011000001100111000001100101000000000100010100100101000000011011110000001000000
00000100000101100001000001110100010001100001000001000001010110000000001001001100010000000110000010011
00100000001110010010101001100100011000000001010110001100001110000010010101011010100000100000001001000
11001100000000000100011010000000101001011100101010000000001100100110000000000001110000100110001010010
00000100000001100010000001011110000001111100000001000101000000000010000101000110110100100000000000000
00011000000000011000110001111111111011111100101000100010010100100110110000101000101001000100101000011
00000000110000000000000000100011100011111100001001111100000000001000100010010000001000100000010000001
10100001100010000010000100000010000111111110100110100100000001010010000000011101000000100101101000100
00000100010001010010001000010010000011111110000000100000110000001101010000000001001000001000001001000
01101001000000000000000000011100100111111100000000000001001110100000000100001000000001010010110000010
00000110011000110010110000010000100001111110100011000100101000000100010001010001000000000011000011000
00010000110111100011110100001000100000111111100010000100100010001110000101000000110000100000001000100
00001001100000101000110100001101100001111101000001010100010000010000000001000010000001011000000000100
00010000011001100000010011011100000000100100010000111000100000111000000100000010001011011100000000000
00101011010100000000000000111001001010000000110000010000100011010100000110000000000100000001000100010
11000001110000000000010001110000001100010010100000000110010010000001010000000001010010000110111100011
00000000100001000000000000110010010000100100001001010001001100001011010101100000010100000000000111100
01000000000000010000000000011000001000010001010011110101010000100111001110000010111110010001101000000
01000011001000000001011000100100000000000100001010001000100000010100100001100101000000011011110001100
10000001100000010110000001001111000100000000101000000000000001100000001001000101000000001110000101100
00000010010000001110010000000100101100001000100001000000100010010100010011100000000100101101110000000
10000000100010011000000111101000001100001100000000001000001100000010000010010101110010101001000100000
00000000010000011000000110111100000010111001101010000100000001001100101010100110001110000000000101100
10100001100100000000100000001000000001001100100100010010100000000110000010000001001100001011000001100
00110001011010010001000000011000011001010000100000010111010010001000110000100000000010000000100101000
00001100010001000000001010000001001010000010000010110100001110011100000000000011010000010100000111000
00000001111000000001110001000001110001010001101101100001000100011110111001001110010100010000000001000
00111110001000001110001000100100111100001000011100101001000000111110000100101000000100100000010100011
00100101000000100100111110010100011010010001000010100111000000011111100101000110000110000001010001111
01000000010110010001001001001001000000100111101110000010000001101100000000111110100010001110000010100
00010001010100011000001100100000001001000001110000000111000000101101000011001110000010011110001010000
10100000000000001000000000000010101000100001100110000000000011000010001000001000100100001100100100110
01001001000000000111000100000010111101000001001101010011100001011010000000000000100000001110000000000
01000001000100000000011000011000000000110000010000010110010100000000001011001000000010100110000010010
00000001101101101100110010000000000110111100101110001100101000000000001011000000000100100111011100000
00010010000100010000010010100110000001010110000111101000100010010100100000000101101001000000010010110
10000001000110000010000010101000010010010000100000000000000110000010100010000010100000000101010000000
00001000000001110110100000010000101010000011110001100010000001010000110100010000011011110001000011100
11110101011110100001101111010001000100001111100010100100000001000010011010111110000001000110001010000
00000010000100110000011010001000011011010100001000000101000010010000111000001000011000010000001001000
00010100101000100001010010000101011000100100000100010110010000110010010101010010000011101001101000000
00010010110110010100100000000001100000101000000000010100000000001000000000000110000000100000000101000
00001000110000000001000000100000000000001000011001000010000000100101100011111001000100110010000100101
00011100111000001100000010100000001000000000000000010001010000000000110000000001000000000000100010110
00011100010001000011000000010000011000001001000111101000111011000000010010110000000000100000000100000
00100000001000100000101010001000010000001110010100000011111000010100011010111100011000100000010000100
00010101000001110001000000111001000110000010010011100100100000000000110100001010000010101000001001000
00010100001000100001110100101000111001000001000111000001001000000000000001000010010110011010111011010
01001100100001111100000110000100011100001001011111000000001000000110101000111111010000000100100000011
00000011101011100000010000000100000111000100011111000010011110000100111000100000001110000001000100011
00001011010010000000111110100100011110000010010001100100001110001111010000100010001111100001000000011
00111100010000101100110010000100111100100011110100000100000100000010000001000000010110100000000000011
00001000001001000000000100001000011000110110000010010011000010111001000100000010000000010010000011001
01001001000000001010000001100100000000000000001011000000101001010001010010000010000000101000000010110
10001100110000101010110110001100111100010100001011101000111000001001001011100010000100100001110100000
00111101000001000000100000000000000010011000001000001100010100101100100111000011000010000001000100000
01100101110010000100110001000000000101010001010000111000000100000010000010000000111111001010010010111
01000111100101000101100011110001001101011100010000000001001100111100001010000100111110100101110000000
10001000110000000011000001000010001100100010011111010001001010010010101010000100010100011001000010100
00100101011000000001100001010100010000000000001000011001101000010011010000001000000110110010000100010
10000000000100010101000110100100011000000110100000001000100101100100000100001110000100100100011001001
00101100010000010000100010000010010111000100100010000000110101110010100001000110000100000010100100110
00100001000101000110000111000000000010000011000000100010110100100001110001000000010100100100000001000
10100000010000000010000010010101000110000100000001000000011100110001111110000001100001100001000010011
11001010110111000100100001000000001000110001110010000000000011000011101000100000000011011000100100000
11111100110000101000001000110011011001000011000000100000100011100000100000111010000010000011100000010
11100000000000011110000100110110000001001010010001000000010011110010000000000100010010000001000011110
