10000111100010100001000001000000010100001000111100000100000111111111110101100000000000010010111100000
10000111000000011100000000100100100000000110111101001000000011111111110000110000000101000010101000100
11100110010000111110000100000000010000000000010101001000101111111111100010001001100110010100000010000
11100100000000011101100000001001100001100001000000010000001111011111001101000011100001000100010100001
11000000010000001001101000000110000100000010001001101001111011000001101001000011111110000001000000001
11100010001000011010001000101000000100011000000010000010000000010001000011000011111111101100000000101
11000001100010100000101001000010110011001010110000001110100000110110001000000111111110000000110011110
00010010100000000001110100000100000001001001000001100110010010000000001100011011111100000110110000000
00000000000001100000100111100010010110001101000100000010100010101000001101011001111000000001000000100
10001010000000000001100111000010000100001000000100001010000100001000100000000100101010111000000010010
10111001000010110110001111100000011110110011000000000000101000011000100000100100000000000010100001011
11001001010110000000010111110000000101001110001000111100000000000000011100000010000010011110000000001
01100000000000000000010011110000110001100000000100001011000101001010000001000100100001010000000000011
00101100110100011000100000100000100000000000100001000010001000010000000011000110100011010000010000100
10001000000111111110001100011101100011010000001000000000000000011000011000100000000001100111000100001
11011000111000010100001000001110000000000101000111001010100011001000010010001101000110000000111000000
11000100001010010111000001100100001000000000000010000011000000010000011100000011100010010111010000101
00100100100100000101001111111000101100000000100000000001101001101010111101100001000000010000000101101
00000001100010010001000001011011010010000000000011000000000000000001111000000011000000011000001101110
01000000000100000110000010000000000000100010000000010001100001111000110010000001010110000010000100100
01001011000000000000000001010000010011011110110010110110000010001000010010101001000010100000000001000
00001001001100001101000000001000000010000001001000001100011000001010111010000000000001010111010110001
10001000001010000100000011100011100001001000000010101111001000000101011100100111110010001000000001010
00010000000000000001000100000000001010000000010011001111000000000000001000001001111011000111100000000
01010000101011010000000000100100011000000001001000010100000000100001100000100001110000011100000010000
11001010011010011100010000100010000000010001100001000010101010010000110011000001111101001100010000001
11100010001101010100000111001010000110000001010001000010000010011010110010011000111110000000000010100
11100010100000000100010011010000011001001001000011001000010101000101001001001001111100000100000000001
00010100100001111100110010001001000000001001001010001000000000011000000000100111111000111110100101011
00000111000000101011111000011000000010000000010000100100100001010010001011000011111000000101000010000
10100000010100100010011101000001100000001000001000101000100000001000000110000001111101010000100000000
00000000010011100000000000001100000011000000000000001100111100000010010010011000010000001001101000000
01000000000000100001010100111000001011011001101000000010010000100000100000111000000010000101001100100
00110000000111000110110000101110100100111110100100010000110000000000010100010001100001110101000000100
00000000000001000100000000000000000000000110000000000000011000001010010011101001000000100000101001100
00011100000100000111100000000011000000000000011001101001100000011000010000100100000001000010011001100
00011100000110000010000010011000000000110000110000001000100000000011010001100001110100010000000100010
00100010000001010001100100011101011000000100000001011110101001000001100000100001000001110001001000000
00010001000000101000000011010101000100000110001000001000000010110001110010011010010101111110011000100
10001000100010000101101100110000000000001000001000110011101110101011101000000000010000000110000010000
01100100011000010000001100010001111100010101010001000000100110000001000101001001100000110000111110000
01000100000001011100100001001100000100000000000100011000010000001000000001000111010001000110100011000
01110110101001100000110001110000000000100000001001001000010000001001000001000000010000000011110000011
00011101100000100000110111110100001111110101100010001000010100001100000111011001110000000101000011000
01000100000100110100100000101000111001110100000000000000001001101101010000100011001000010001010000000
01001111001000100111100000000000101101010000001010010011000010011010000000100000000001110100110110010
01001100011000000000010000000110001000001000001110111101000000000011101010000001001100010000101101000
11010011010011001100000110011110000010001000100100100101000100110100000000001011100000000000100100001
00000000000000111110000101101110000001000000001100000001010100001000101001001000100000011100100000001
11100000000000001100011000000011010000001000000010001001001000101001101100101101110000000111111011100
00001011000000000000100111000000010000000110100100100110000000000010010101000100110010000100000001000
00000000011110000010010110000100010001000000001000000011000010000010100001100010100110010001001100000
00001000000000100111000010100000000000000101010001011000010000100010000111000000011000000100001010101
01100000000100010111000111101100000000001000010000000100011010000010001100101110100000110100000000001
11100100101110100011011000010010001000010000100000100100011110010000010000010000101101110100110010000
11110001011100110110010010010001000100100010010111000100010000011000111011000000011001100001000010100
11111001001011000000100010010000100000010000001110001001101000010000111101000111000000011100001111000
11110000000000001001000001001101101100010000001101010001001000111010011000101110100001000110011111001
11100010010001001000001100010000001010100000010001001100000100110011100110101110011000000000000011100
11100100100001111000001110010000000000100011100100100101001000111010001010011100100000010010010000100
11110000101010000000000000100000010000001000100110000000000001000010000001011110011011110010000101101
11110000001100010000001010000101111000111011010011110000011100100011110000011000100001000000101101111
11110010010100100101101010010001100100100000001000001010100001000000010011111101000010011011111111111
11100000000000001100111100010011000101111010001101110000001000000000001001111000001100000000000011111
11000010001000100000011011011010100011000100100000000110000100100101000000110100101000001001000000111
10000001110000000010011000000100101000001001010110110000000101100001000100000100000100000010000101111
00000010100100000001001100100001000011100000001110011100000100000100000001000001000010100010001110100
00000100100000000000000001010000010001110110001001001000000010000101011001001100100000000100000100001
01100010001000000000000000000000001001110000110010100000000101000000000010000010010000010000000110010
00000000100111011100010101000000100010000010100000100001000000011000000110101100001001000000000000010
01010110100001101000010100001100000100000010111101110101110001001000010000001000010000000000000101110
10000000000000000010111100000000000001000011000001100110000000111010100010000000001110010000001101110
10111011011001001000000011101000111000010100001101000000000001110110001010000000010000000001001000110
00110101010010001100000111001100100001010000000001110000000010100001001000000010010000011111001010000
10000000001001000000000000000000100001000010000001000011000000001000001000000000110000100010010100000
00010000010101000000011001000001000001110110000111100111010111000001001001001001110010000000000001100
00100100100000001000100111000011101010010111010000001011100000000100000101010011100000100000100100001
00010000000000000010000000001111110011000000000001010010001100001000000100000011110010010011111000010
00111100101100010000000011100011111100000100110010000001000100010000000111000011110000110110000111000
11110010010010100111110000100111111110110010011010100000000000011001011110100100000010000100001111001
11111001000011100000000010110011101110110101101001100100111011000111110100110010000000001010000000001
11111100000000101000000001000011100001000100000000000000000010001001100001001001010100010000000111000
11011101000110100000101100110001110000000011000010100010001000010010000100100001101100101100010001011
00011000000110110010001110001001000001000101001000010100000000100111001100001011000010101110110010100
10100001110001010101001110000010010011000100101001100100001000001100101101000010100100001000000110001
00000100010110000001000001100000001111100100010011000111100100011001100011011110000010000011101011000
10001110101001111000000110010001110001110010111100010011000110000001000111011000100010110000000000000
00000101001000001011010100000000000000101010000011100000101001111001010100010010010001000010100101010
10000000000000100000000011000001001100100000000000100101111000000000000000011000001011100000100000101
11100010000100001001100100000000001010010000100001001000111000000011000110000101000011100010100010000
10010111000000001101001000001001000001100110000101100101110000010100010011010000101001001101111011000
10001000110100001101011000000010101010010001100001000000100001010011000001110100001100100100100100011
10100001000000001111111010000010110000100011100000100010110010000011101000000000000110110000110110000
10000010100010010001111110010000001000110111000000010010000000000010000001001001010010001010010000011
00010000110000001001111110010000000110100110000001111001100001000010100010000001100011000010111101001
10000100110100100000111000010100000000000010110000111100110100010110100100000110100001000100000011101
01000011000010000000100000101100100011001000010000010000000111000010100000101000101000000100001000000
00110001000001001001010100000110100010000010110100001000110110000000100100000000100011001001000010100
10001000110001001000010010001011000010111100000000000001100001001000001110001000000001001000000001001
11100001000000101011011001101000000100100010000111000001010000000000000000010010000001010011000000001
11111100001100011100001100001010010100000110100111100100010111100001000001011100000011010001010000000
