00100001100000000100010000000110000000000000100010001000000001000010111100100100101000101000000100100
00010001001101100000000001100100010000000110001100000100000000000000101000000000001000001001011010001
10001010001001101100000100010010000100010101001111100101010111010000000000000010000000100001100001000
10010001110010000001000010100010100010000000000111010000000000000011000011100000001100011101000011100
00010000001011001011110000010100010011000001000000000100000111011001010011111001000000111101000001110
00000010000000000101111001110010001000010010010010101100010011010001101111100000100001000100011001100
11000110000011110000111101110011001100000000000110100010000001010000100011110001111010000011000000000
00000000100001111100001001111010000000000001001101000000000101111010000011100101100111001111000001010
00001011000011110000100010110111011100110001001001010111100100001000000001100100000111101111101011000
00100000010000000000011010000000010001000010000000010000000010001100011000010011010001100010100000001
00000011100100001010000000001100010000101011001001001100000011000000001010101001100000010000000000001
10100000000000101100010011100111000001010100011000001000000111000000000101000000000001100000101010000
00001010100000010000001100000000100011000101111001010000110000100000000000010010100011000001001000010
10000000101100000010001111010000111000011001010100000100100101000001010001000100001000100010000001110
00010001000000001010001000000000100000100100000010001110111100010011000111000100010001000000100100100
01000001000101111001001101100110100000100000001010111101010000000110011110000010001110010100011000000
00010010010000011000011110000101000011100000011110001000001000011000010110011000010100000000101001110
10000001011010010100011101001100100011011001010100000100100010000000100110000000010010111010001100000
10001000000000010001111100011010000000010000100010010010010111000010110100100001000000001111000100000
10011000001000000000110001000011000000110010011000111000010011000010100001100000001001001011010000111
11000000111000001000001001110010000010001111100001011001101001010100000000000000010011100011001100111
00010000000101000000100000100110000000000010000010011000001001100000011000000111001101100001011000000
01001010011000100001001000001001000001000010000100001101000011011010010011111001111000000000100011011
01000101111000011010000100000011011000000001010001110001110010000000000000001100100000101000000101000
11101000000000110010001001010000110001011000010000010000110011010000001000110010001001000000010100100
11000100001000000000000100000100000001001111001000000111010110001010000110000100000000010011010000101
10001100100001110000001010000011100101101110100001110100000011001001001000000101101000000101001010111
11011000101111110000000000001000000011000000000010110001000000000100000001001000110100000001000001111
00010011000000100001110000000010001101010001000000101001100000000000101100100000000100110101000000101
10010111100001001001100000000010000100101000000101001001100000010000000001000100001001110001000001000
00000011101011101000101010001000000000000100000000100100100000000111110000101101000001100101100000000
01000111000111110110000100010001010101011000101101010101000011010000001010011000100100001000100100011
00000110011111000000101010100010000001100101000110000000000011000010000101000000010010010000100000000
01000100010000100000000011001110000101001100000010001000101100101111001000001000000100110000100101101
10010110010010110100000000000010001000000100000000100000010001000100010011010000000011000000000010000
00111001101100100000110010001010110000010100100000001001010100010100000000000001100000000010000001111
00010000000000001000001100000111000100100010000101100000100000110001010000000011100111100100011010001
11001100010101001000000101000010001011000001010000110001000000001011000001010010010000010001100000001
11001110010000001000000000010010100000111000001000011100000100000000000011100110111001001001110000000
00111111111001010010101100000000011111001000011010110010000100000000110001001100110000100111010001000
00111111101000111001000001000100100000000010001011000001000000000100001011100001110001000001000000000
00010000001010001100101010001100011100110010001000100100011001010001011010100110100100111000101110010
01000000000010010010110100000000000000111100000001111000000000000001001000000000000001000000000010010
01000000000000000100100010010000010001000011000100010000010001100000000000110000000010000100011101000
00000000100001000000001000111010000010001001101100000000000000010100110011001110001010001101100001000
01010000000101011010100000111000001010000111110010100000000100010010011110001111001001100100001011011
10000100110000001000010111111101001010010111100010110101000000110101000100011111100110000100001001110
00000000000001000001001000101000000100001000100111111110000101010000100100011111000100001011010000000
00010100100000001010000000100011111100000100000100111111100100000100010110000011000000001000000001111
00000001010100011011000011000011000001010010000100001011100100010001001000010010000100011100000111111
00001010000111010000101001100111000000100100010100100000000010000011000110100000100010000001000011111
00100010010111010110101100001111101001000100000001010110100111110011000000010000000001000100000100111
00000000000000001001000000100111110001100010000100001000010111111001001000010101110100010000011000010
01011000000010101011011000010011100000010000000000010000100000010001100000010000000100110101011100000
11110100100010000000001000010111100100001000010100010000110001001101100010100001000000000110001011110
01010010000011001000010000001111100100100101000001001011001000001000100001001100000000010000000011010
00000001000011110000000111011110000001001100000100100000100000100000000100011001000101010110010100000
10001000000001010100001001011111001010010001110010101100100000100001000100110010000000000001100001101
00111000011001000101001100011110000000100010000111000000000110010001010010000000000000100101110110000
00000100000011011110010010000001000100100000000011100101000011001101000001001000001000000001000010000
00000001000010100101000101111001001001000000000101010110010111100011000000001000100100100000000000110
01100001000010010000010000001100000001011000110000000000000010001100011000101101000001000011000010101
01000010000000010100100000010001100010100110110011010000000110010010000011001011101011010010000010001
00000111100000100000000000000000000000001100000000110001000001000100010000000001111100000000010001011
00010010010000001000000000111010000001000111000110000000010010001010000000100101111111100000000100101
01000000100101001000100000001101101001000011000001010001111010000000000010000101111100100000000000100
00000000100000101010100010000000000101111111100000100010011011010011001100000011111000100001100000010
00000000000000100000000011000011000110010100110100000100100100111000101110000111001100011001000000000
10010000001000010000000110000010000000000000000111000010000010000110000100000111000010000010000010010
00001100000110001000100000100000011010000000000111101000000010001000000101001010010110100001000111000
00011100010000101011001010000000010001000011100001110001110010011001010010000010001000000001011000001
10000000001010110010100100000001001000000011110101010100000000000010001111001000100000010111000100001
00000010010000000110001001100100000101100000110011000000010100000010110111100010000010100001101000000
01101000000100011100001000010100011010001100100000000000011010100011000011110000101110111000010000101
00000001000100001001110000010011000010000001010111110000000001001000000011100000100000011111001010101
01010000001100000010000100010000110100000000011000000101101100000000010001001100100101100000100001101
00001010001101001000011100011010000100100000000000000000101100100010000000000100010010000100000001010
10010001000100000000000000000101001011010000000000011000000000010000000100000000001001000110010000010
10110111000010010100000010100100010000000000010010000010011010110000101110101000101000100001100001000
00000110100000001000001001100010000000000110000000010000001111100111111110100010001010011000000110000
11011000000000110001000010010000110000110000000010101010011111100011111100010100000110000010001000011
01000000011000000100001010000101000011000000011111100011011111111111111000000001010000001100000001000
00001000000000101000100001000101001101101010011110100010000111111111110000110001010001000010000101000
10001110000101000000000100000001111000010000111000001110011110111111111000100100000011000001110110001
00111101010100000100110110011011000101010010011000000011100010111101111000010011010011010000000010010
00111100001100000101110000000100011000100100000100000000000000011100111010000010000000001111000000000
00100011001010000001000100000101100010100000100101000010000001010000101000011101000100001001000001010
10100000110010100000000000000001000100000101001010000001100000111100000000011101000011000100101000001
11000110001010000010001100000111001000000100010000110000000101110000001000000001000010110101001000011
00001001010011001001000111001000000000101111011010110100001001100100010110011100010000011100001110111
00000010101000000010000000011101110000000100000111111000001010101110110000111000000011000000101000011
00010010000101000000100110000001110010111011011010001001100100000100010000010011010000000001101101011
01000001000011100000111101000010000000001011100000010010000010100100000000000111000000001010100110011
00001111100001110000000100000100000000000000011000100001000110101000001001000110100000111000000000011
11000111101000000000001001100111001100000000000010100000100100100011010000010000100000100100000000101
10000111100001100100000001100111100001100010001000101001100000001010000010001010100101000001100100000
00000100000000010010010011100000001010001111101100001100010101010000010010100010010110000111000000000
00010000110010001001110001001000000100000100011001100111100010011011101010000001100110011001010000111
00000000001001110010110111101011000000100000000100100000001010001000100110000011001000011000000010100
10000101000001111100000000011110001001011101110001010000001000100111110100000101001000100010010000000
10001111100001111000010000000000110000011101000100000100100001001111100000001100011011000010000000110
