00001001000001111100000000001000000000011110000000001111000101110000000100011111100000000000000101111
10000000011010001010011100100000000000010000000100011111110101111001011000001111000001000000000000111
10000010000001100001001000010101000001000010010100001110010001110011000110000010000000100000001110001
10010000000010000010001000010010010010010110001010100100010100001011110011010101000100000001010000100
00011000110000001001000100010010000000100011111001000011000100001100001010110000001111111100000001101
00000100100000001000001101000000001000011010100000001100101001000000000000010101010100010111000110000
00011000000111100100101110010010101001000000000100010100010010001000000100001110000000110000000100001
10000011000000001000001000010000010001100000010000010000000100101000000110100100010101000010100000011
10010000010100001000010100111010010101010000010010010100100001100000001000000000000000000010010010001
00010011000001000100010100101010000100001000010001000001001001100100000000001000000010000011100001111
00010110000000000010100110000100001011011011111011100011000100001000000010100000000000000000001000011
10100110111010101011110010100000001000010010011100001010101111001110111100100110000000001010101110111
10000111011101110000110010100000100110100000001100101110000001011000001100110100000100001000000011011
10101110000000001000100001110001110011000000001001000001001000011100010100000000000000110010000000001
11010101001000000100100100010000100000000101000000011100010010011111000000010000101100111010100001001
11000001010110000100100100001000100001000110000010000000000001000100010010100000110000011111100011000
01010101010000000010001000100000100111000000000100010000000110001100100001100001110000010011101000010
01000011010000000010001101000000000000010000010001000000010001001001000000100100100001000000110000000
00000010100110000001100101100000100100001011111010000110000001000000101100000100000101001000100001000
11100000000001000110011000000001100000000000110001010010010001100000001011110100110001010001001001010
11110001100000001001011110110010001000110010001111000000010011001110100000000000001100000000000010001
11111100000100110000010110010011011100011000011000010010010100000000011000001001000101010001000010000
11111000011011000011010000010000111101100010101001110100111000000011000010110000101110010000001010010
11110000001000000000111000000101101101100000000000001000010101000101000110110100000000001001101000000
11100000000100000010000110010000001110110000100010100101000010000000001100110010000000111100000111000
00000110000000001011000000110100001010101101000100000000000111000010000001000111000011001111000011100
10001000000000000001001110101100101000000111100010010000000000100010100100000000000000000100010011111
01001010001010010100111000001110111000000001101000010001000100000100000010001001001110001000000001111
00000000010100000001110000010101000000010100100001100101000000000101000010001100000100001010110111111
00010010000101100001110001000000010001000010000100000000001100000001000110010000000000111001010001111
10100110100100001000110110010110100010010001100001101000100010000001111010000001001100000111000010011
00001000101010100000000010011000100101010000000001000000000100000000100000000010000011111010001000100
10000010000000100000011011011000000100100101000000001000000111001000110000100110011000000010001000000
00000000000100111001011000100001110001110010010000111100110110010100010000000010011000001000000000100
01001100001001000000101000100000101000000111110100000010000100010001100000110110011000000000011101000
10101000001000100000100001001001000101010001000000100010110010100000000010001000001101000010000000110
00000100110000001110010110010000010001000011101000100001000010100100010000000100100001011100010001110
10101000000110011110010011111000010100010011111100001000001010101000101100010000000011000000010100010
11011000010000011111000011000010010000000111001000100010010001110010001110100000100000011000000100100
01010000000100001111111000010000000000000110000101101001000100100001111100000100000011001100000001000
00000001000101101111111011000010010010010000100010000000000001001000110101000010001000001001000001001
01100110001111001111111111010001000010111100001000100010001011110000000100011010010000000001000001000
00000000001000100111111111101000100000001101011000100001110011111000011000000000000000110000001100010
00101000010101100010111110000100000100010000010111101100100000110001000010101100000010000001010001000
00000001010100000100111100000101000001001000000000001000010000010100000010100000000001001000000111100
00011000000000010101001110000010000100001000010100100000101001000110011100110010000001000000001100110
01010001101110110000100000000011011011000100000001010010100000000000000000000100100000100010000100000
10010100011110100110100001001100000000000000000110000111100000010100001000000010000001000000000000001
00001101101110001100000011100001100010100101000000001111000000011001000000010100000000001000000000000
10000001101100110000001100000000000001100000101000000110000000001001000001001000000010100001000010110
11000010101000001001011000100000000100010100000010010100001001000100011000111000001110101100000000010
11000000000000100000011011000001001001000001010010111111100000000110011101000001000000111000011100001
00010001000011001000010011101100011000000010011001110000100110011001001000001100000011100110010011001
11000001101000000000100001000000011001001110001000000000000010000001101000110000110101110011001000101
11000001000010100001000011010000100100000010011011001110000010000000000000000000000000100000000000000
00001101010010000010000111111110100001010100100000010001000000110010011010001100000000010001001001000
00010111000000010000000110010000100100010001000010000000000000100100000100111000001001100010001000100
11000000000010001000000010000000001011010100110011100100010100000011011001000000011000000001000010011
11100110000000100000010010001001100000010100000000000000001010100000100000011000000001001000001110001
10000100100010110000100111100000010011110000100000100001010010001100000000100001000100001000000001000
00001111110001000000000000000001000000010001110010010100000110110010100110100000010000110000001010000
00000001001001011000000000000001011100100000101100101001000001010100000010001001011110001010101010000
00110000001100000000011000001010011000010011001011100111011001010000000000000110101011011000010100100
10000110011000001110010010100001000101100011001001001111000011000110000000000000100001111000000000101
00001000000000110011001000000011000000011000001000000100111010000000011110000000100000100000001101000
00001000111011000100010010000000000010000101110000100000000101110000000011110111000010000010001100000
01001111000111100000000001000010110010100101010101000100000000101100000000010100010000001001000100010
00011110100001001110000001001000100000110000000000110000111000101100101000110000000110101000000000000
00000010011010110000010100100000010101000111011001110010001100000000010000001110000010111111100000101
01011010110010010000010000000010000000100101111000110000111100111010001010000111100000011100000001100
01001100001000001110000010110000001101110000101000001100010000010001000100000001000001001000000000000
00000001000000001000100010001000100011000010000100011110100001001000001001011000001000000001001000000
00011001111000000001101100001000000000000010000000001110000000010010001000111101100010111010000100000
01010111011010000001100010100010000010000000000100011101010010000010010100011101010000101100110110000
00110010010010101000010000110000000000010000000111011000010010001010000011001000000100001000001000110
10000001011000001010000001110010001011010100000001111010000000000001100100000000100000100000010001010
11010001000001001000010001111000000000010100111000010000101100010011000010010110011010101010110000000
00011001100010000011111001100000010101000000101011000110000010100001100100010000101100000110010010010
01000000100100010011110000001010000000011001000000001010100100000000010010000001100000110000111001000
10001101000000111001100000000010000100100010010101011010010110001010000001000110000010001100010000100
00000000001000100011111101000010000000100001000000000000100010100000001010000000100010101111000110111
00001100110000001000110001000111000001100000000010100111000011111001000000000000000000001100000000001
00000001001011000011001110100001001001000010000101100010000000011100000001001011000001000000000010100
11000001011100001000000000000001001100000010000100001011011001000000110010000010000000000000010000100
00000010001010000100000000000100000000000010000001000110000001000110111000001000101000001000001100000
00110000000010111010101000110001010111000010111010001110100001000000001001100000001000101000011101000
01110100000110000010000000000110001000101001000001011110001000101111000010111000000100000000111001110
01101010100001011110010001010100000010001100101010000111110000010000010010000010000010000001110000100
00000000000100001000011100100000001000010000100001000111111110010110101100000111001000010000010110111
00011000000001000101000000111001100001100001100100001110010101100110001110010010000110000000001000111
11000101100000010000011010001110100001000001010011101000100100000100000010010111100000000011101011111
11100000110010000000100000110000010001111000000110000000001000100001010010100111101000000001100001101
11000100100010101001000100001001010001111000001111110000001000100001100000101111000000000001100001000
00001110000000100010011010000101111000000001001000000001001001001101001001001000101001011000110000000
00100100000011001000000010000001011010110100000000010001001000000000101011000010000111111101000100000
00101110001000100011110001110110011110001000000100000000000101110111000000100010000011111000000000000
10000001101000000010100000001100000000001010000000100100100111111000100100100000000000100110101001010
00000000010010001100101001100001000001000110100011100000110001110000000010010100001100100111000001001
00010010110000000001000000001100000000001000010110000000110010100001000100000000000010010010000000100
11011100110000000100110110000000100001110010000100010001100110010000000000101011100100000001101000000
00000010100000101000000100001100110101100000001000111001100000000010010011000000000000001000101000101
