00111110001111000100101100000001000000001100110100011010010000000010100101010000111111111010100100100
01011101010100100000100100000011001111001110000110000000000000010010010000011000101111110000001001000
00011001000010000001001000110100011110011100100000101010000010010001000000000000001101100111100101011
00000000000011010100100110000100101100011001010001000101110000100000010100110110000000001000000100000
01110000000110100000010010100000100000011100001000001000001000000000011000001001000011011000000000110
00000110001010001001000001110001100000001001010110000010000100000000110000000000010100001001001011100
00001001000011010001001000100010101011000111000001001011110000010010010011010100000000010011100000100
01001011000000000000001110011110010000010100000011000010101000000001001111001100000010000001110110000
00001000001111000101010100111001000000001000001001100000000110000000010010000010000010101000000000001
10000000000000001100000111011000011001101100000001101100000010000100010000001000000001100100100000000
11100010001000000000000000000000011110000000010000000110100010011111001101000000011011110100000000011
11111001100000000000000000110111001000011010011101101001000011000111000000010000101011101000010110001
10100000000101001010100001000011010000000001000010000000010111001001100000001000101001100000101000001
00100010000011000100001001101001000010010001000110001111001010000001000001000000100000100001000111111
00001010000010101101010000001000010000010110001010000100011000100011110000111000011110010000010100100
00110000111010010111100000000000010000010001100001001010010000001001000000000100010010000001100001001
00000000001010000010010010000010011110001001100111001000000000100001001001000100111001100011001101000
00000000101011101000111011100010000000000100011000110010101001001101100000010100010000110000001000000
10111000100010000111011000100100001110000100001000000000101101100000100111001110111000000001000000011
00011000001100010010010000000001100000000111000000001010001000010001100100000101100001000000001100010
11111010001110100000100000010000010001000111100101100000000000000010101100000100101000011000000011000
00110100000000000110100000000101001110000100100001100001000100100000110101000000000001010000100100110
10000000000000101111000001001100010000000010001010001001001000001000000010001001100000111011101000000
00000101010001110100010000000000011000010110100001000101111100000011000000000100010000011111111000000
00100010000001100000110011010000001000101000101101000000000000111001000001000011000001010000100101001
01000000100011010000100001010000100100100000110000011100001010111101010011001001000000000010100000001
00000100100001000000000010010001000000000000010001010000001000110000000001000001010110110110010110100
01000000010110000000100000110000000010100001000000100000000000010000100000000100000000010011000001101
00011011000000100101001101111011011010000010000101100000001110000000100101000100000100000010000100100
10010000100011000000000110100001110000011001010101001010001010010100110010000000000001100010000010000
00010000001000010000101110011000001011000001010100101000001001001000000100000000000000000011100000010
01001100100101011000101100010000000010000010011100010100100000001000011101000100001000000011000010001
11000001111000000101000010000010100001100000000110010110000001010010101111001001011110001111000000001
00011000001010000100110001001011111100010000000100110000000000001101000100000100001000010100010000001
00000111000010000001010011011001011001000010101111100010010000000000100000101010100001110000001000000
01100101000100010000001000000000000001000101100000010001001110011010000000010001100010011010011010100
00110000010000010011110100000000000000000000000001010000100000011010000010100001000010000000000010000
00001001100000000001000101011010100010010000100011100000000100000010100010000000000001001001010011001
11101000011001100000100000000000100000010000001111111100101000000000000001100100010001100001011000001
00001010011100010101000010000000000011010010000000100011110110000001010110001000010010110000000000001
00000000001000000000000000100100101001100000100110000011110010001000101000011000100000000111000101100
00000110010011000000101010000010010000000100000011100110000000001000001110010001000000010000001000000
00001000100001000000100010100100100010000111110001010000001001001001111000001000110001001010000000110
10111000000010000100100000001100110001011101101101000001100000001100100000010001001001110011100100000
00010001001100001001000110110010011101001001100010000001010111000010001010100100100010010001001000110
01010000000000000000000000001000011101100100111011001100000000100101100100000000100001010100000000111
01111110011111001100000101000100010100010110011010111010001000000100110100011110000001000000001000010
00100000001011000110010110000000100000000110000000001001011000000010000011111110110110000010100100000
00100011000000100000001000000000010010000001001000010000000100100000000101111110000010010001000110000
10000110101000000100000110010011000000000000111100010000000101001000010101111100000000000000000110000
10010100010001101100000110000001000100001100000000100100111100100001100100111011000000100000001001101
00011010010000111111011100010001101000011000010101101110001010000110001000000010000000100000000000100
00001000000000011111001011010000110101111000011010011110000010100011010001100000010010001100010000100
10101000000100011101010010000010100110111001101000111100100000000000010011000100001000111110010010001
00000111110010001000001001100001000000010000000000001000000000000101001010001010011100001111011100010
00110111110001010110000100000000100011011000000000101000001010110000100000000000001000100110000100000
10000111110000000100100100000001101010101000101001010100100011000111110000000100000100001111010000001
00011111111110011100010000110110000000000000010000000001111000010111101010111000011010011110010001000
10011111111000000111000110000001000010100011000000001001100000001010000100110000100001010010110010100
11001110011011011000010000101110000001000001000000010000011010100010010100000100001001011001000000100
11000011000000000000100100101110000100001010100011000001010000001001010110100011000111000001000101110
10111000000100001010000010010100000000000000110000000011100101101000000101110000000001001001000110010
00111010000100010101110000010100010000010011000000000011110000001000111000100000010000010001000010111
00000000100010000000111110100001000000001000100100000101000001001000000010011000111010001101000000010
01110000000001010001110010110000001010010000100101010000000010110000100000000000000000001000010110000
00100001001101110000011000000010111110110000011001000010001010000000000011000100000000110000011111000
11001010001100100110011100000100100000011010010100000000100011000001010000100000001000000110000010100
00000000011100011110111001000000000000000000010000001001001100000000100000010000000101000011011100010
00001000001001111110100000111000110101010010101000010010000010101101110011000010011110010001000011000
11000000100000111100000001110010100000100101000000100100001011100000001000101001000000010010000000000
00101000000010011101000010100000110010010001011000100001001000001010100011100001000101010000000000011
00000000010000011000100000010001111000011011000100000000100000000000100010001001010100000010101010111
10100010001000000000100011000010101000000000110001100001000101000011000011000000000001000000000011111
11000010101000011010100001000100000100001010000000000000110100001000010010010100010000100000101111111
10010000000010000000000000101110100000010011011000100010000000101101100101011010000000000100001110001
10000100111000000000000010101111000110100000010000010011000000000000000000111001010010000111100100111
11001000001011010000100010000001000011000010101100001001100000100000000111111001000010000111000000011
00000000100000001101111010010110000111100100000000011010001100010001100000011100000000010011001001000
00100000000010101111101001111001000111000000110001011000000000100000011000000100000100001111110010000
00101110000000001111100001110001010111011000101000110100001000010000110100100000000110011111001100101
00110000000000000111100100100000000001000010101001110110010000000011100110000000100000011010100010010
00110000001001000011010000011100011010001111000010010000010001100001100000000100010100000000111010000
00000000010001110010010001011110000000100010000000111110110010001000101010001000001100000000000010100
00100110000010110000000110001110101011000000100100011111000000100001110011010001000110100010100101010
01101000101100100000000010000100000000110001001000011100001110000001110010101100010001000000011000000
00000110100110011111000010001000000000000000011000101001011000000000100110001011010001010000000000001
00100010000000100001011001010000000010100100100111100011100101000011001101000011100001000000000011111
01101000000000111010100101000001001011101000000001110111010000100011100000010001010011000111101111111
00000010001001010000101010000110000000000000010000100100010000011010001010110000010010000100001111111
00101110011101010100000001001010010001000010100101110010000110010000000000001000001010100100000111111
10001101111010000000110110000011111110010000100000000000000100000011001000010100001000100010111111111
00010000111000011111011000101000010000001000100011000100100001000110010000100011100000110100111111111
11000001110000001110010001100011111100000000100000000100110001000101000010010000010000000101111111111
00000000111100100100110011100100111100100000010000010000000000110000100010100000101000000010111111111
00011000000010000010000011100000010101000000010010000001001001011011111100000000000001011000001111111
00000100100000000000000001010000000001010000100000010001011100011111111100011110010000000000011111111
00100011000101110010001101001000010000001100000010000000001000110111111000010010110001001011001101111
01000101000001010101100000000010001100010010001100000010000110010111111001110000000010100011100001111
00000000000001000100010010001100000000000010011011011100001010000101110001111010000010000000000100100
01000001100000000000010010111001000110011111000000100101110000000001000011111010011000000000000000000
00011001000001001100100110011000100111011111110000100000011000010000001001000000011100000101110010000
