00001001100101100010000000000000101000100100100011100100000000010000111110010000001010000011111011000
10000100101001010000111000010100001001000000111001110000100000010001011110100010100001100101110000010
00001000100000011110011100110100000100000010010000000000010001001010010010010100110100110001110010000
01000100010001000111000111100000000010110000100000001000001000010000000010000001001100111000111010100
00000110000000000000011000000111000000001011110101011000100000110000100000111100000000010101011000001
11000101100011000110001101010101110001010100100001000001001001010001010100001010000001000000001000011
00000100000000011011010101011001100001000000000001001000000001000100000000001001001001000001000011111
10010001001000000000110000000000010010011000010100000000100000001000100000000000010101000101001000111
01100101001100010000111001000100110001010000001100010100101011100111000101001110000001000000000000111
00100101000000010000000001001101100000000000100000001101000111000000010001101000000000000000110101111
00000110001000001001000000010011000000110000000001111000000110000110011000100111010000100110001001011
10100100000001000001110010000100010100000000001001111101011010100000001011001111110000000000000110000
00000110010110000010001100010011111010100100100110010000101010000100000111010111001000100010001000000
01000000000000011100101010101001000000000011100100010001000000001110110111000000000000000000100010000
11001000000001000010111001000001100110000001000000101000000101000100110010001000011000100001000100000
00000000011100000000000000010000000101001000110110000010001000100001011011110010110000010000000001001
00001100001110000011000010101010010000010000000000101010010010000000000000010100000001111001000100011
01010010000110011000010100100000100000000100000010000011010000010010101010000001110111111001000000101
00000100100100111000110000000001100000110101010010100000011100010000000010110000110011110010001111001
01001100010010110010001000100010010100011000000000101000000000100010100011000000011001001100010010000
10101110001000011100010110100001000000000100000000000000001001010000001110000101100000000000111010110
10001111000001000111000000001010000111010000010010010000010001000100000100010001000000111000111001000
10000110000000001000111000100010000000000010000111011000010001010000001011001010000111000000011000001
11110000001100100000000100000001000101101000101001101000100100010010010000001100101010111100100000000
11100101001000000100001000010110011001111100100101100110111000011000001000100010000000000111000110000
00100000100100000110010010000000000001000110000000100111110000000110110100000000000101110001000010000
00000011111101001100001010001000101001000010001101000010110010010000100000000000011001101000000000000
01000001110000010001100100000101100000100010100000011000100000100010100001100111010010001011001100011
01001110100011100000000100000000101000000100010010011000000010000100000000000010000000000010000100001
00010100000000111000010100001000001000011100010000100001010010000000001001101001001010001000000000001
00100001100100000001000001101000000000001110100010011001101001000010010000001001011101101001100000000
00000101110011000011101000000010100100101000000001111100000000100001000010010010000000000110010100000
00000000000011101110000010001100111010110000001001111111100010011111010000000100010100000011001011001
11010001001001111110010001000001000000001110100100111110101000001000001100000101100000100000100001000
11000000001001111110111001011100001110010100100001110100110000000000000110010000000000000100001001101
00000101001101111111000001010001001000110100000101110000010010010000000000110000110001001110001000011
10100000000100111111101010011011101010010011100110111000000010000100110011001010010100001101001101001
00010001000000001111010000000001100000000001101000000110010000000100110100000001011000001000001000000
00000011001011000101010100000001001010000011000001000010110100000000000000011100000000010000010001000
00001000000000100100010011100000000011001000011101100100010100100010101111010000110000010110000001011
10000010101011000010011000000100100011000011001000000001111000100000000100111000000001000010000000000
11000000010001001000111000101101110001100011001100000001110100010001010010010000000101010000000000000
10001010100000000110000010011000000000000000100000000000110000010000000010000000001001001010100000001
11101000111101100000001011100000011101100000000000001101100010001111000100010100000111001001001000001
11101000100000011111000110100100000101001000001000000111010100000101000011111000101010100001000100011
11010000000010000100000010000000000011000010100000000000000000011100000001000000000000000000010000000
11000001000100010001100000000000101111100100000100000011101011001000000010010000011010100000100110000
00010111000001010011111110010110000011111000011110000011000100000000100001001110101010010010101000100
10100001010010100011000001000000000101001000000101000010001000001001000111000101000010001100000000001
10011000001000000000000100000000111000000010100001000011000100001100000100011000000001100110000010011
01000010010000010000000011010000000100000110110101010101101000100100000100010111000000000010010111011
00110010101000000110000100001110000100001000010111001000010000001101000001000010110001000010010111111
00000111000000010100100010011100000010000001011000110001001010100011101000010010000110010111100000111
00000011100001001000000010000000100001010000000000000100000111000001110010000100011000100011100000011
00010111110100110100100001000100010001111010110000001000010011000001101010010100100101001011001101011
00100001101001000000000000011010000000010000001010000100011010001100000001000000001111100000001110011
00010111100010000110000000000000001011101000010000110000000011101001010000000100100010111010110000000
00000001101110000000000000010000100000000011000011100001010100110010100010010001001000101000010100000
00000100100000011111000011001100000000010001000001000000000000000100010100010001000010000000100100100
00011110100010001010001101000011011100000000100001001110001101010000100000000100000001000000100100011
00000100001100011000100000100000100010001000000000001111100101010000000010100000000001011100000000000
11000100000000001001000000000000000000001000010111111111110101101110000010010000010101010111011000000
11100000001010100100100011000010101000000000100110000111111000000010100111001101010100000000000101100
01011101101001001010001001000001011001000101110010001001111100001000000100100000100100010100000001010
00011000100100011000001000101000000001100001000010100000111011010100110000010100101000010100010010000
01000110100010100010011010000100000010001001010000001101110001010001000001000011000000100011111100010
01100010000000000001000001110000001000100001000101010000000100010000010111000001100000000011000110000
01000010000110110011110011000000101001000100100000100011100001000011000000100100000110000100000111000
00100111001011111111110000110000101100010010010111011001100000000000000001000000111000100001110111010
00100110100000111111110001100000010001010100000000010110010110110110000001000000000100001000000000000
10100010100000001111111010000011000001100000101011000010000000001100011011100000100000000000011100001
00010000101000011111111000010111000101000111000101101000000100100010100000000100100010001100000001001
10000110100000011111100011011110001100001111110000000100010000001010001010010010000000110100010000100
00001000100001011111100100000100001100100111111110000111001100010000011111110101101001000000011000000
00001000000000010000000011000100001100101111111111001000110001000000001001000001000000000010110100101
00111100110100010000010000000100110110011110010111011000001000100011010000000100000000000100110000101
00000110000111100010001010001100000100111110000011100100000000100010000100000100100000000000001001101
10001001001001000111100000000000010001111111001001001110010000010010100010001001101000100000101001000
11000100001000001110000010010001100001111111100100000000010101010000000000000111000000000010011000000
10010101100001001000010101101100000100110010010000010100000011010001001100000100001010000010001110100
00000010010000000100101001000001010100001000000100001100000010000101010000000101010000010111001000010
00100000100000110000000000100000110010011011110001001000011110100100010101011001000100010010010000010
00110101110100000110001100010001000100100011100011100000110100001000000101001010111001000001001000001
00001000101000000100001000000010000010001000100001000000100010110110100010111000001001000100000110011
00000100101000100000001011000000100100010000011100110000001001000000101000100000001110001000000000001
00000000100001110010001010000011000000010100000000011001000010001011000000111011001001010000000001100
01000001110001000000001000001001011000011100101010110000100111100000110001010000101000011101100001110
01000011101101100111111101000011001101000001110010010100100011111000100100011001100000011100100001100
00001001100110001000110100001011100101100000000001111100100011111000010011010011000100100000010001000
00000001000110000001000000000001000000001010110100111101010111110000110000010000000000100000101101000
01001001001000101101000011001100100000100100100101111010000100000011100100010000010100000011000000001
10000000000100000100100000110000100000100000000000110000001110001100100000001000111100000110100110100
10010000001010100011000001010000000100001000010100101111001100000010011000100101011111010000110011100
11001000001011000000110010001010000101101000000001100010010100001000000100000100001110000101001000000
11001000010001000000111000000010100100010011000001000001000000000010011000110000100000000110001010111
10111000100000010000011001010011100010000000100001000001011100010100000000000100000000101000001000111
00100010000101000001010011110001010101001000010000100110000010101100101000011001000010000001110001011
00000110100101000001100001011010010001000001110101110000011000001111110000001111001000010011110000011
01100001101110101000000111001000011000110000000001110000000010100101100010111110100000000111111101001
00100100000100000001010000001000001000100100000001111100000001000100010000000000100010011111111010100
11110000000010100000001100000000100000101110000011110001100000000001010100110100101010000111110000000
