11111001000011100000001000110000110010001100000000001000100000101100100100000000000011110000100010100
11111100000000100100000001110100001000100111001010110010101001000001100001000011000000000000000000001
11111101000000110100010000100000000000000100000010100000100101100100101000010000110001000000001000001
11111101000000001000100000000000001101001100011110000100010001101000000001000111000001111010011000100
11000000000001011001000101110010000000111001011010100000010011101010100010001000000011000000011110000
11000110000000100100100100010000100100100010000010101000000010001011011000001000101011001000000000001
10000011110000001100000001100110000001111000000111000011010000011000010101000101100100010010011000100
11000101001001000000010000000110100101011110000010101010100101000010100011110000010000000000111110010
11000001100000000000010100100000100100001000000000000100010100010000011000001001010010000011111110100
10001001010000100100001110100110011110100011010001110110000010000000000001001100100000000000011101010
10100110001001100001001100000000000000001110101111000100011010000000110001111000000001100011100000000
10100001000010001000100100100000000010000000001000100100011111011100010100001101000100000101001011000
00000110001010101010000001001011010100100000110000010110101110000001000101110000001100100101010001001
01001100010010000010001001000000010001010010110000100000000100010010100011010000011000100100000001100
00000010001010001011011000010001100011000000010101000000110010010100000000011001001010000110100110001
00001110110011000011000100001100100100110101101000011010010100010010010000100000001000000111001001011
01000010010001000010100000010001001001110001001010010010100100111001001111110010000001011001100100011
10001000100100100000000010000010101100000110000010100001001001101010011011110010010001111100100000000
00001011110011100001010100010000011110000100000000001101000101000000010011111000000111011000001100010
10010110000000010100000010000100011111000000000100000000100000010000000001011011010000011101001000001
01100100100000000000000000001010001110000000000011110000000000110001000010011000010100101010100100000
00001001000000100011001011000001000111001100000111100011000101111001000100000101000011000000101110000
00010000010100010011001000011010010000000110000011010010001110010010010000010110100000101100000100001
11000000111001111011001011100001001100001010000000000100000110111000101100100000100010110000001110110
00100001111011000000001010010010000100000001100000000100000010010001001110100001010000001000001100010
00001101100001100000000001000000000010101101000100000011000100000000000100011000000100001000010011010
10000000001011000100000010011101001000011100000011001110100110100000000011000000100100000010001010000
11111110111000101010011000001000000010101000000110001000010000000101110000000111110000001100000010111
11100100000110000010100111100100110101000001010000000010010001010001001111101100100001101011000001110
10100011001000000001101000110100011000100100011000001001000001100100000011010000000000010000100011110
00010000010000000001000001110001000010111000011110000100011001110000000100010101001010000000000111100
01000101000100010001001000111011010010000000001101010000100101110001001000011010001001000111010111000
01010000010010010000001000000000000101000110001100000000001000000011101010000010001001101010000100000
11010000100011100010001100101101010000011000101001100000101001010000010000000000011101100010000100111
11000101001000100101000001110000001000000011000000101000101010100000000010110000111110000111000110000
10000000000010000000010100110110000101110010110010110000000010000001110001000101011100000010110100001
11000001000100000001001000001110000100100000001000000000100100000100000100000000011000110000111000100
11100011000000001000100000100101111000000001001000001000010010100001000000001011001010010100111101100
01000100010101101101100000010001000100011111000001000001011001000000000000000000111100111010110000100
00000010000011100100100100010100000111000101000010100010010000100000001101001010001000010001110001001
01000000100111000110000101000101100000000100100000101000000000110010100010100100000010100000100110100
10000000010111001000100100001000001100110000110101001100000101001000011000100000000011000111100000000
00101000001010000000000100000011100011000010100001101100010000000100100010000000011010000011011010000
00001000000000000101000010000000010000010001000011101100011000010110010110001001000111100001000100110
10011001100000011110000100111010010001100000010011000010101011110000101111010010000000000001001101001
00010000111000011100000100111001010100001100010100000001000000100000000110001110111010111010010000000
11010000000000001000000101110000100010100000000010000010001001000010001001000000000000010100000011110
00000011001001011100001000111011001100010101100001010100010100001000000000011000100100100000100011100
10110010101000000001010000110000001010001010101000000000000001010010100010010000001100000100000001100
00001100000010101000000001110110010010010000000101000011110000100000000100010001010010001000000110000
00000000000000010010100010100100100001011100000000100000101001110101111100010011101001000111000100010
00000100100001110000100000000000000000100000000000010001001110100110011000000001000000011000011100000
10100001000110001101001010000000010010100110000000000011100000001000000001001110010000100000011010101
00000010000001000000000000000010011010101010000011010011100010001000000110100010000001001100001001111
01010010011101100110000010011001010000100000000001111001111110010000010000011100000000100001000011111
10111100100110000000110100001011111000000000100000000010001110000001001101000101010001001100000011111
00111110100011101001100000000001000000000000011010011001000100010001011000010010011011000100011000111
01111100100001000000001011000000001000000110001110000000000010010111111001000000000100000101000001011
00011001000100001000000100001110000110001000000010010001010000000011000001101111001100111000001000000
10110000000000100000001000101111100000000110010101111111000000010001100010001110000000011001001000000
00001100000001001000011000000100000010100000000100111111101000010110001010000000000010001000011111000
11001000010100000000010000110100011100000100110001001111100001111000000000110010001000101010100000000
10001000000010101100011000110010000001100001011001100111111000010001000100001000000000000000001101111
00001001110001000000000001000100000100000000000000000111100001000001010111010000000100010001010000000
00010110011000100100000000001110001001001010000110011111100000000000011001100111100100000100010011101
11000000000001001100111011100000011101111000000000000011110010010111100001100000000110000000100001001
11010011000000000000001111000011011100000001001010011111010000001101110001101000001100000000000010000
11010000100100000111011111000011111100000000000100000111000000000000100000100111010101100000111010010
11001001011000000000100110000011111110000000010010101111010000101000101001000010010001110100100000100
11111101000000100000001000001101101101001001100001101111100000110011001100001001101000101010000101000
11100100000000010100000000100000000000011000100011111111100000100000000010010010001000000010001000001
11001110001000010110000000001101000000111000011101101111000001001011010000001000100010000000100011000
10000001100000001000010000100010000100010000000000000101001100010100010001000000100001010000111001000
10000001000101001011101000011000010010000000000111010000011000000010001110000010000000000000010000000
00110000010100000010000100000101000000001101110001001110001110000010110000000000000000010100101001001
10011010001111110000001000000000000000001000010000011100001000101100010000010000000000100010100000100
00110001000110111010001001011110000110100001000110001111100110101001100010000000010011110010000000000
01010100000000111001100111111001001000100010000010100101001110000010001000000001000001101100000000010
10000111000101000000011000000011111100010000110110001000111110000000110001000001001100000110111000000
00100000000000110001011101010101111101001010111110000010011110000101011001100110101000000100000101000
11000011100000000110000001100000111000000000101110010101001010011110001010000100000000000100110000000
00000100001100000000100000000011110010100001000101101100000010001111001000100000000000100001000100100
01000000011100100100100000010111110100010010001000000000100010010111101001100000011000001001100110001
00011100111111010000000000000001110000001000000000001000100100100001000000111001001010010000100000000
00001100100000001001000000110011111011001100100000000001000100000011001001111000000000010011100100101
00000000000100100111000100000011001000010110000000000000000010001001000011000101000101001001010010011
00001100101000000010010000010100000011000000101000000000101001110010000000001100010000111100001100111
00000011000010010000100000000000101010011010011000010010100010000000000001001010010000001000000100011
01000010100111000000100000001010001100001010100000001001101001000010101000010001010001001001100010011
00001000001001000010001100000100001001101000001011000111000111011100000000000110100100000000001010001
00110011001100000111100011110111000010010100001100110010110001001000100010000100000100010100000111010
00100001011010101100100001110001101100000010001100000000000111001100000100000000000000011100101110000
00010010010000010000000110010000001100000011011111000001110010010010100000000101001000011111001100100
00001100000110000110000101000001100010000000111110110000000001001011010100001111000010111110000000000
00110001000100101100110000010000000100100000001100100000000000101010001000000000110101111101000110000
00000001000001001000110001000001000010000111001000000010000000000000011000000000100000001100010000011
00100000000000010010101001011110100110011110000100000001100000011010110100000000000101000000000100100
01000010001011000010000001001100000110111111010000000000000010000010000001000001010000100010000000010
01001110000000101101101000001100100001111111100100000100100110000000010100100000000111000110101010000
11010110000000100000001010100000101001111111111111010100000010111000001000000100001111011110011000001
10000010100100100000100000000001001011111111111111100000010000001100100100000100111111000110001000000
