00000000101110000001100000100111000000010111111101001110000011110000100000000000001111100000010101111
00001000000111100001001001001111000000000111110000010111000001101000011000010001010011000001110001011
11101010110011001010000100011110001001001011000010110011000000000000100110010000000001010000001000011
11001100001100010000110000000001000001000001111100000000000001000000001000001100001001011000100000101
11100000001100001000000000000101011000001000000000001000000000001101110000000010101001000000000000100
11110000111000011110011001001000000010000101010110010100000101101001111100100100010000110110110000000
11111000000010111000111010001010111000010000110110100001000100001100010100000010101110010000110100100
11110000001000010010111010001000001010000010110000000000000100000001000000011111000000001101100001000
00100011100000000000010001010010110000101100011000000011000011001001000100000010101110000100010100010
00011111001110000000010101000001011010010000010000100100001111100110010010011000001000000000001000001
10010001010000000010100110110100001100111110100010100000100101000101100110111001100001110000001101111
10100110010000101011001110111101000010000000010000000110100000000000000000100000000100111010000000001
00000001000101001111101010000000010011010010001100101101001100010001000000000001010100000110000000000
00010011101000000011000001100010100001100000100001000000010000000011101111100001000001100000100000001
11111001001001011000000000010100000000101011111100100000000001000001010011000110001000111000101101001
11110000010000011101000111111110010100110001110010001010001110010011000001101000000000000000100001001
11111100001010011000011111101101000000000000000000001110010100100011000000000011011010000010001100000
11110010000000110110000011001100100010010001100100001101010001110101000000010000000000000000111101100
11001001001100000001010101000101000001000001010101000000000101100000000101001110101000010001101111110
11101000001001100101000100110000100000100000001100111000000100011010000000001111011000100101000000100
11001100100000100011000000000000010100010101001000111000100010011000000001001101011001110001110001110
11000001001000010110011011101110111110011111001010000110001001001000001000000001000100100000100011111
10000101000000001001000111000101101101101011001010000110100011100000100100100001010000010100100001110
00000000000100000011001000101000000100001000000011100001000011100000010000000000001000000000101000100
11000000000100001011001000110000000000100001000000011000001001010101100000100010000010100001001110000
11001010000001101001100000010001000000010000101000000100011010000111001000110000101000000100000000100
11000100000000111011000000010000100000101100100000100010100011110000000100010100010000011001101000001
11000001000100010000000010000111100101000001000000001000000001000100110000000000100000000000000000101
11110001101001100110110000100000100000001010000100000010011101000000100100100001100100000000000010000
11111011010001000001001101011000100100100101010000001111000001101010001110000010001111001000010000001
11111010000000101001010010000101000010000101001000011111101110100000100100011100100001000000001001011
11101100000110001100010111000000000011000000000010101111001100000000001010011000001110110000011110011
11000001100000100011110010010011010011100001000100000100010011100000000000001010000010000010111000110
11001000001000000001000010011000100101100000101000000100010000100000011001000001000101100000000010000
10101110010000011110000000100100000100101000000000001100000100100000111110010000001000100100100000000
00000010100101001100100100010000011001000000101000100111101001000100110111111000000010000101001001001
01110000011101011010000001001001100100000000000000010011000000000010100000100001010000010000100110000
01111011001011001010000000100010000010000010100101010100101000000000011100000000100111001001100110000
11110010011000111001011100110111000111101001010001000000101000000000001000010101111010000001000000000
11110011000001000000000001011111101000100000001000001010100100010100001100010010010010100000111000001
00111010110110000011010100001010000010100000110001011100010000001110001110010100100111000000001011011
10001000111111010101011000000000000011000101000000100010000010001010011110010100001101000010000000011
00000000111111000100011100000000100000000001100001101000010100100001001100010001101100000100001111001
00101000110001010010010110100101110010010000010010011101110000000110001101000101011100000001100010111
00010011101000100010000010001001000000000000000000011100111001100000100010000100010000100000010000111
10000010000100001111000100000000001100010000100010000000110000000000000000110010000111111111110100111
00001000100010000010000011000000000011000100000111101001101000000001100010001000010011110000000101110
10100010010010001000000111001000000111100111000110000101000001010100000001011000000101110001000110000
00010100011000001000010110000000000000000011100011010001010101000000001000111111101000111000001000001
10001001000111010000010000001100000000000001000000110010010001000001000011001111001000000011011000010
11101101001100000110101010000000010111000110000000000110010101100010001000000100000000100100010001000
00000010011110101011101000001000101001000000111000000000000101010010000001100000011010100000001000000
10001000111111001010000100000001000001000000100010000010000001000000001000000000001000000100100011000
10000000011000011000011000000000000000000101110000001000000010000001010000100001000000010010000010001
00001000101001000110000001110010100000100000110101100000001010101110000101000001010001000000100010011
00110000101110010000000010010110000000100101110010000000010001000010100011101101111001100110000100011
00010001000000000110111100001000010100010001000001000000101000000000011110000110011000010000010111111
00000001010001010000010010000001100010101000000000000001100100100110000000000000010000001100000101111
11001011001101000101010110000011100010001100000111000100010010001000011010110000100001000000000000111
00010000010001001000000011000001100000000011011000100000100000101010010010100001000100010001000100011
10000000100000010000001000010011111010101001100001110000001000101111000100000100001000000000100100011
00001000110110100000011000000000110010011100101100110001110100100010000011100110010110011110001000011
01100000001100000101000001001100111001111111010100110000100111000100110000001011010000000001100000011
10000011101110010000000000110000000000111111000010010000000000111000000110101001001010000011000101000
01110100000010000101101010000010000100110110100110000110001100100000010100000011100000000101011011101
00011000100000001000101001100011101000000000001000000001111100100100000101100100001010000001000000010
11001011100010010110100100000100000100010001000000100101000000010011100001000011010001101011101000000
00100100010100100010000100010010000000110100010110000100101001110000000010000100001000000001100000110
10000110000110000100101100000001001000001000000000011000100000000011100000111011011000000101000011000
00011100011111000000100000100010000100000000001010100000100001000110000000000000101000100000100101001
01000001000010000100000100100010000001101011010111001001100100001000100000000100100001000000100000011
00001000100100001001000000001001000000010000000110011100000100001100100000000000110000100000010001101
00001100001100000000010000000101000000111000010001011110011110100000010011010000000100010100100111000
10010000001110010101000000100110011000011000010110101100100111001101000001001000011100000000100010000
00001100010100000000000001000111001110000001100110000100001010101001101001010010000000001000011110010
01000110110111100100000110000000100100001011000101010000101010100001110000110000010110001100000100010
01000100000000010000110000001001110000010100000100000100010000000101000010000110100001011111000001000
11101000011010011010010000100000100010110010000010001100111100010000010100101111000001001111010000010
11000010011100100000100101010101100001000111000010000011100000000000001000011110100110011111100010000
11000000011000010000000111000101001100000000100001100010101000000100001001011100010000111111100001001
11100010111000000101000001001010010000100010010000110000001000000001100000010000110000111111101010111
11010010110100010100001100000000000100100011111011000000000011100100001100111110000001011110010000001
11000000010010111100100100000001110000010101111000110000000100000000001000010010010000011110010000000
10010110011000000010001100000000010000010001111100000110010000000000100000100010000000000100000000000
11100100011001000001011000100110000001100000101010001001100011000000001010000110001100010101000000000
00010011000000100000010001000000001011100000100001101100010000000010100111100000001000100100000101101
00000000001000010010000001000001000001001011100001100000000010101000000010010000101001100000000001011
00000000001010010001000011010000100000111111110000101000101110000010000010100100001000001000000101001
00100010001110100000000000000000001010011011111000010000000001010000000100010011000000010010000000011
00001100100001010000011101000100000000010001110100010101010100000000100001000110000110001000100000011
01001001100000000010111110010000000010000011000000011110000011000100000100110001000000001000000001111
01100000100100001001001000111100000100001000001110000100011000010110100101000000000000110000100000111
00000001000000101000000000010010110010101000100001000000010000001000010000000101100000100110010100011
00010000101000011000101111101000011010010101101100100000000110110011001000001000111010011000100011001
10000000100000110000000100001000001000010010100010000000010000001001001000000000010000100000000000011
00000100100101000100011000000010010000110000001000000100001001000001000010110001000000101000000000000
10001010101000001111111110101101011001010011110000000010101010010010011100111000010111010000001100000
00010000100000000000010001000000001001001000000100000000101111100100000001000100000001001100000000000
10001100000000011000010000000100100100000000000000010000011111101000001010010100001000100001001101100
11000010010010000000001000000100010001100100010001011110011000000000011000100100000000000000000101101
11000000100100011100000001000010001000000000001100001110000110100001001100011100000000010001100001101
