11111111110111100000000001011100011111110011100010011001001111111010001000110000000000001001001000011
11111111110011110011010000001100111111100111100110010010001001100000101001010010111100000001010001001
11111111111001111100100000000010001110000011110110000000010011001010111000001001100010001000000001010
11111111111100110101110001000010110000010101000010100001000000000100010010001000101110100011000000100
11111111111100010000010011101000001001010000000100000111010000010001010000010000000101000010000010001
11111011111001010100110001010000100000001100000011110110000010100000111000101010000101110000000100001
11110001101101010000110011001100001100011101000111101100000011110000100000001000010101000000010011001
10111100100100000000010001010100011111010000010101001111010001000001001010001010000000101110110000000
00011000000000100000010000000011111100001000000001000100000010110000100000000100001010100100100011001
00000010100010001001000000011010001110011000100000001100001000000000000000110101111010011010001001101
10000001000011000000100001000001000010100001000000000000101001000100110100010000011100110010000001111
11000100000001001001100100000100011001000010100000100010001000100101110011000010000110100011001100011
11100100100000011010101100100001100000000110000000000000110000001000001010000010000010000001001101001
11110010000000000010100001010000110100000101011100100010101010000000011000000000001011001110100100000
11010001000010110010000010010011001000010100111000010100001000001010001001000000100010000000010100100
01001000000001000000000010010001001001110010010001011010001000000000000010010100100110001001001000101
00000010000000111001000010001001100000110000000101001000001010000000010000110010001111000100011110001
11100000001001100100101100000010100011101000000101010000000000000101010110000101011111110000011010000
00010001001000100000111110000000000111000001000000000100000100000000000000100000101100000000100001101
01010000000000000010000001000100000011100001000000000000010111000001000100100001101000000100010100011
10001001000001000100101010001001010001100000001100010000010111000010010011001101100100010000000100011
00001010100100100111000101000010010001000001110100100001100011100100100001000110000000000000001000001
10010010011000001111100100100101100101001110000000100001000111010010001101001001001001001100000010011
00010100000001000111000001010000101110101100000001001011000111000000000011010000000000101111000111111
00100000000011000000100000000000000110110001000101101000000111010000000100001110010010111110010011111
10000100000010010011000010101100000000101100010010010010000100000000010000101100010111000000000100111
11101100101001100000111100010101001100001111000011010010110101100000010100000110001000010101000100011
10000010010011100101110000000010000000011101011001000110101111001011100011100001000100001100010000111
11000010001010110001100010000100000101111000100010011000100000000111000000000100110101010000000100101
11010100000100000110000100010110010100010010001000110101101000000000000000001000101001000000001100000
10010100010011001100100000010111110000000000000011010010110010111000001101111000000001000100000010001
11001000000001000001011001000010100110001000100010000000001100000010000000010000001001010101010010100
10100110001011010101011110010010100110100100010001000001100101100000001010000011111010011101100001100
00000010100111110100000001000000000010000100000101000011011110010000000000000000000010110000010010000
00000100100100011000000000101000111011001001101111100100000000100000110001000000000000110110100001000
00000000000000100010100010101100000001100011101101100000010110000101100010001000110000011000010101100
10000000101000000011000000000100010011000110000000000000000000001101100001000101101000011000110000000
11000000000100111100000000100000000000110111101000001000000111010100011010001100000001000010000000010
10010000001000000100010001010100100000000011000000100000101000010000000111001100000110100010000011010
01000011000001000110100000011101110000101000000000010000001111010000100010001001010000011000000011000
00000100000000001100001010000100111111000010000100000000010000000100100001101010110101100010110010111
00010000101100110000010001000111101010000000000001001101011011001101001011110110101001100101000010100
01000000000010001010001110000000000000101100000100000001100000000011100001100010000000000001010000000
01101000001011010000010000100111010010110110101100001100010110110101110011111000100100001100011001101
00100000010010001000000000100001000001100011001000110010001001100000001000101000000101100110000000011
01000100000111001110100010010001000000010011100100100000000001001000001101000000000000100000000110011
01010101000000110000000001000011000011011000010011000000100101000010010001110110000110100100100000011
00100001110000010001010000000001000110000000010000101011001101101000010011000001110000101010001010001
01110110000011000000110000100001010100000001001000000111011000100101001000101010100001101001010000011
10110101110001001010010100010101100010001000001010001111010011001110010100001000100001111000000001011
00000000110000010010001000001000101110100000111110100111000011111111000000010011011101100010000010001
00000010000010001001001010000100000000100000111111001011000001111111001000000000001010010100000010000
01100001100000000000000000101101011101100010011110101001010100111110011000101010000000100000110010010
00010011100100010100000101100000000100001101000110010000110010011110000101000000100000100000000000110
00100001000111100100010000100100000100001100111000000100100101001000101000000110110000010000100000100
00010001011101001000000101110000011101000000110000000000101100101000110011100000100000111000000110001
01111101001100100110000001100010000010101101101101001000000100001101110000110000000010000001000010011
10010100100110011111000000010001000000110000000100100100000100000110100001000010010110101101000001111
10000101000000011010001100010010000011001000110000101001011000010110011101000100000000000010110000010
10000000000011001011101000010001010110000110010000000100010010001100110000100001011001010100011000000
10101000001011000010100000010101010001011101000100010101010001011100100010000100110011000001000000000
00000010011100001010001100011010000010010000010000010001000000011000010000000010000001000110001000111
01100010100001011100000000100000001000011001000000000000010000000101001010000010010000011111000100011
11110000010001011101101100100011000000000111000010000000010000010011000000011100000010011111001001000
11000110001000011000010110100001000000000000000110100000011100001010000100011000000000001010001000100
00100011100000111000100000000000100001000011101010011001100000111100000010001011101000011000011010010
00001010000010010000101110110011011000100000101000001101010000001110000011000000010011010101001000001
00010000011001001011111110100001000101100001010001101111000100101110110000001000011000100001001011000
10000000000100110001111110000010001100010101000010000000010101000111010100011000001100010000001001000
00000001110110001011111110000100000000011000000001000010100001000010011100010001000000000101000000111
00010000101110011111111110001101010000000000110001001000000000000001000000100111100000000000010000100
00100011000110011111111100100100000010000000010001000001010010000010100100001001001000111100010100000
00000001000010111111110010000000100000010001011001000000000001101000000001011101000010100000001011000
00001001000100011111100000001001101111101000110011101000000010000001010000101000000010100101011011000
00000100110000010110000100000101111111001001100100000010100010110001001110001000000000100111100011000
00000011000000100000001001010011011110100001010000000011001000010000010000000100011001000000000100001
01100001000000001001000000000010011010001100010000011101000100000000000100111100011010011001011010101
00111000000000000010100011101011010000100100000110001000001001100001010000001010011000000000110000001
00000100110000110010000100000000000001100101010000100000001000000000001100000001010000010010011010011
01001000001001000001001010000000011000000100111110000000000101100010011100010000010000000000000100111
01101111000000001000000000000101001100111011010000011001110001101000000000011110000000110000000000011
00100011100010000100110000000010000001100000001000111101000101101001010011000000000100000001001000011
11111100001001001110000101100111110000100001100011110100011011111001000000011110001110010000000000110
11101000000010001100110000110110100101001000001000100011001001000001110011010001001100001010000001110
11100011101000001111000010010000000010000111100100010000001100100000001011001000001010100010100000100
11101000100000000010001100000010101000000000000010100001001000000000101000000011100011000010010000000
10000100100110000001000001100000101100000001000000000010000001010001000011100110000100001000000100000
10010000100001010110000011001101000010010110100101000011000100001000100100110111100100110100000101000
00001101100100100000100000000001000110001110100000000111000000001101001110001001100100000010011000000
00110010000010011100000010000101010000010000010000000010000111000001001110011100000000100001100110000
11101000000000001000000010011110001101110001011010000100010000011001111110011111110100000110001100010
00000110011000101011100000000001111100110000100001010000100000000000100100001101111001010100001110000
00111000100000000001000110000000101100000101000001000101010110000101000010000000100000010000010110000
10000001000000011001000100000000000001000010000001000001000110000010010011101010001000000000100100010
00100000000011000000010000101110000101001001100000000100000010010001011010000010001100000100001011100
01000000000100000010000100011000000111110001000010110111000000000000000010010100001101000110110001000
00001010000000010100000000000000100111111001010001110011010001100000010101001000000001101000010001100
01110011001000100000100000110001111111111000100000011000000000000000001001000001000000000101101100001
00110011101000001001000000100000101111111100001100011010010010000100100000000101001110000100000000111
00100001000100001101100010101100001111111110101010000100000001000001000110001110001110010100000011111
00000001010100101000011100000000001111111111000010000111000000110101000010010000100100100100010111111
