01001000000001111111100000000001111110001000000110110000001000000000000011000010010011110000001111111
00000001101011111111101110100000001000000000000000000101001001000110011000000000100010101000011111111
00100010001111111111110010000000000001100000100111100100000000000000000000000001000000000000011111111
00000010000011111111000001010000001000000010100000000100100010000010010001101100101001110001001011111
11000001011111111010000000100010010011010000110101000001100101000101100100000000000010011110000000101
00001001000011110000000101111000110000000011011010000000000001010000000011010010001000000010010010000
10100010000100100110000000110010100001000001011000001101010000100000001001000000001101110100110000000
00000101110001100001010110010101001011100000000010011100010100100100101010000100011100111010000100001
01010000010100000010000100001001000000000010100001001000100110000000000010000100001100011000001000000
01100000100000001000001110100100011010001011101001010011111010001010001000110000101000000000000010010
00000010000100010000001000000000000001000010111100000111110011000101010000000100000000100011100000111
00000110001000001011010000000110000001000000111111110001101010001000000011011011011000100101110000111
00001100000011000001000001000000010011011101111111101000000011000001100101000000010000010101110000011
00010010100001001010100101001001011010001000110010001010010000010110000001001000000010101101010110111
00010000000100010000100000100111011111010000000100000100100011111000011001000010111000001000000110011
00010011111001100000100000000000000000001000010100000000000001000000100000000000111000000000001100101
11010000000010000010000111100010000100000000011010000101000001001100110110110010011100000000001110000
00010001111000000111010010000110010000010010001010100001011000000000000000010000100110000000001111010
01100010111000000010000010101010010010100111000000000100110000001000001001100010010010000110100110001
00000000001100001111000000010001010001100001100000010001100110101000001010100000100010000110000101011
00000000100011011010000001100001000100001000001000110000000011001001000000010101110111000111101001001
10010011100101011000000001001010000011000000010000001000000001000010100100000001110110010010000100001
00001001001000100000001011111000000110010110000011011000000000010000010100010010110001111010011101000
10100000010001111000001111000100000010100011110100000001010000001000001010010100010000011001111111100
10000110010011110011111001001000000010000000000000000110000111010000010011100110000000011000111111100
11100000000011100000000010100000001000101000010010000000010111000000010010010011000000110000011111100
10101000000101101000100100010000111010000100000010000010000001000000100010000000110000000100000011000
00011000000101011110110010000000000110011100110000101000000010001110100001000100001110011101100000000
00111110001000000000000010000000000001100000000010000000100000000000001000000000000000000010010001000
00111100100010000100010000000000000000000110001111000001100001000001001001000010000100011110001100100
00011000010010010111000000100100010010010010000000010101110110010100010000000100000110000000101001101
00101010100000000110010100000010001001110000010010000101000000010001000001000011101100000000100000010
00100010100010111000010011000000000110000000010000001100010000010000010100010100001000000000001100000
00011000010101110101001101000010111000000001100111110111000000110000100010100111001000001011000000000
00001000000100010100000000011000011100100100000010100000000000000101011000100000000100000000000100100
10100100001110000101001100000000111100000000110100000000000100000000000001000110000000011000111110000
11000001100001010110000100100011010001100000000100100100000000000000000000100001110100011000111100000
10000000100110010010001000001001011000100100110001111010000000100100110000110000010001000110011111000
01100010110001100001100000100010000110000110011100010000000001010000000100100011010101111010011111101
00000010001000000000010000101001000010011000010010100110000001001100110100000011000000000000100111010
10000001000001010000001101000111001011000001101000001001100000000100010011010001000001000000000011000
10000001001000000001000101000111001101100000000100100001010100000000100000100001000010000010000000000
11000011111101001001111000000100000000000010011000100000000001001010110000000101000000100011010000100
11000000101100000011111000100010110000100110101010000010001001001001101011001100110100001010001100111
00001010000000000001000010100000011100000000001000001001000001001011100111000010000001001101100110011
00010010000001100001110100101000000001010110101001100000011010010000110011000000000100000001111001111
00100000010000100100100000010000100100001000110000010010111000111100000001110100000011011101101010011
01001000100010100001000110000000010111100000011000000110111000000101010100000111100100101100000000001
10000001100100100001000000101011000001111010100001000110110000000000110000100000110010001000001000011
00000011000001110100001000010000001000100000100011100001111100001000100100100010000010010100001000001
00011100101100100110011011001010101100001100010100000101001001100000000000110000000000010011110000000
10000100011010000100100010000100011100100000011110100100010000100001101010010000100000000000000000000
11001101000000110010111001010001001100010001001000100000000010101001110000111010011101000011101001001
00011000000000010110100000000000000010110001011010100100011011111100110000010000011000000001100110001
00001000100110010000101011001000101000000001001010100010111100100001000110000010000001111101000010001
10001100000100100100001000000000101000000000001011110001111100000111001010110011001010000010000100000
00100011000100010001001001000010001000110111011001100101101110100100000001110011101101001011000100001
00100000100000000000001001010100100001001000000001110100000110001000000100001011001100100000011010000
11000000010000010000010000100000010000000011110000000010110000000100000000000001100100000110100010000
10100000111110000010000000000000010000001111110110100111111011001100010001010111101001100000010001100
10001000111110101010110011000100100000111111000110101000010001110101110111100011000111001010100101110
11000000101100000001110100000010000100111110000010000000000000000000010011000011010111000110101001101
01000100100011010111110011100000000000111111000001001110000010100001100000000000000000000010010011100
01010111100011000001000001000000100100111110010001000011000000010000000001000001011000001100100000000
01000111011011000011010000010101110111111110001000010011001000100100101000000000000100100000000010000
00001000000000000110000110010101110011111100110010000101000001100101000000000000001001100011010000100
00001001000011100010010111000010000111111110011111101000011001111000101000010101001100000100100000010
01000101001000000000011011001001010011111100011111000001000011111000001000101001000000110010000000100
00100001000001001001000000000100001000111100000010000000000010111000001001000000001000000010100110000
01100101000110101000000001000111001001110010000001001010010000010010000010010001000000011011100000011
01000001000100000100100100101010001011110001110000001001001011100000111000000000101001111001110011001
01000011100000010110010000101000100111100101001100000000000000100000000010100100010100011000100011101
10001010001010010010000101111001110000010011000010011100000000001000000000100011010011101001111111001
00000000000000000001000010111000111001000010010010000011101001010000000000000100010000001010000000000
00000000110110000001110010101000111000010000010100101100100000111101010010011110010010110010001111100
00111011000010100100110110000101010001001001100001111010000010000010001001000001000000000010010100010
10000000000101000110111110010000000101000001101000111000010000110010001000000000001100010100100001000
00000000110000000000100000000101010010011000000000111100000000000000101010001000010100100001000000101
00001110100111000011111100000000110001011000000110010111001000001100110010010010010000000111110000010
10100000000000000011100111000110001100011010010000000100011000000000000000000100100000010000010000000
01010000000110001000000111110000000001001100001000100000001000101100000011001011000000001110111000100
01000001001001011101010001000000100000111010001000000000110101011101101000000001000001011101100000100
00100000000010001001001000100000101100000010001000000110010010001001110101010000000110011100000011000
00111000001001010100001000001100000011110000000100100010000100110010110011110000000000001101001000001
10000000000010000010001001011000101010110100001000000100000000100000001000000000010010111111001011011
00101101110000111000100000000111000010000100111110001000010001000001011000010101000100011111100100111
10010000000010010001100110000100001101011000011110001001000110010100001000010110100000001111000010011
00001111010000011100000111111001100000100001001111001110100000100100000010001100001010111100101000111
00001100110001100001000010010000000011101000110010011100001000000110110011001010000101011000011001110
00010000110001110001010000010100001001000101000100010101011100110010001001011001100100010000000001110
10000110100000100011100111000010010000001100101100000110000010110000111010110000000000000010001000010
01000100001100001011110011000001001001001110100100011111000001111000000000000111010010000110000110000
00100001010001100011100001100100011011111000010000000000000101110000100010010010000001100001001010001
00000011010010000111000010100100000010010001010000010000000110100011101100011011100000000100001000111
00000110000000000010010000010100100100000100000000001001000000011000101000010100110100101000111110111
10000111100001010011000110001000111001000010000010111000010000101111001101100010001010001111001100000
11010111110111000011001110000000000100110110000110010000110001001100001001101010011000000001000100010
10001011000000000001000100000100000011000001010100001000000000010000100000000000000001010100001000001
00111000011000011001000000101100000000000000000000001010000000010010000111000010000100000101111100000
01000000100011011000010100000001000100010110100100000011100001010011010100000100010001010001000100010
00001100011000001001000010101000000010000100010100010001000100010000100011000001011100001100011100010
