11000010000000001001100110111011001000010000110000010001011010001100101100000010100000100000000011010
00100011100000100000100000110010000010000000000001000000000011000000000100001010110101000001011010010
10100111100100010000000000000010010000000000000000000001100110110000101011000100001100010001010000000
00000011001010000011010010110100001010000100000000000100000010000111000010000000001100000011100101010
00000000001000000001010001100100000011000010000000001100111001001010100111000100100100000100000010000
00110100000101000000010001111010000100000010001001100010000100000000000001001001010100111010011010000
10010000011010011011100100111010000010001000001100010000100000011100001100000001001100001000100000110
10011110000010001000110100000000000100001000001110011100100101011001000110000010010010010000010001000
01000001001101000010000000000000000100000001101000010000011001000000011000000110000000111010011100000
00100000011001000000000100000000101100111000000001100011010001001100000000001111100010100000100010101
00000110001000010100100000001101000010111000000010101000110000010000010000001010100000000000000001001
00001000001101100000000100010010000000001101101000000001000101000000100000101000000001100100111100000
00000000001011100101100000111000000000000111100101001101000000000100010000100110000101100111111100000
10001000000001111100000010001001000011010001100000010011010110010011001000000001100000100000111000101
00000010000100100001011010011000010110000101001001011011000001010100000000000010000000100000101100000
01001111111111100000001000001100010100000000010011000000100010000101100100000010101001110101001001100
01000001111110000000011010000100101110011001000011110010001010010001110000000001110000011000000000010
00000100100111110000010110000011000110011000010000001000111010100000100000001000111001000000000100110
00000110000010100011000100010100101000000010100100100010010001000100000000001101111100100111111000000
00000110111010010001110010001100000000011000000010011011110001100000001000111111110000010000010001001
00000001001000010110100101011100101110100101011111101111111001011011000111001010111010011000000000010
01101011001100001100000001111000000110001000111100000001111100010100100100000010010111001010010000000
01010010000101100010001000010001010010001000010010000001101000100010101100010010010010100010000000001
11010100000000000000010000100010110001100000110011000100000000110100000100001011001000100110100000101
00001000000000010001110001100010000001000010000001000001000000100000001000101000000110000000001000101
00100111000000010000000000010000011011010100110111100000010000000000010000000000001000011101000100000
01001110101001010110110000000001000100000001100100000100101110110000100101001000000101010000111010011
00000000011000100010000110001111010011000010000100100010100010001000000100000010101001100001110000100
10011000000000001000000000001001000010111000101100101001000000100010000000000100011100001010111001000
00100010001100010000011010110010001010000001100000000010011110000010101100100010101010000100000100000
01001010000010111000110001010110000000001111110100000000001100000011010101001001000000111110100100100
00101111100011000000001000000110001100011000100001010010100010111001000001011100000000101001001100001
00001010000000001011000010000111000001100000000110000111001101100001010100001000110110100011010001100
01000000000000001010001001000000011010001001000000100011100000000000000100000000010010000000010100001
00000010011101011100000010000011000000100000101010100111000010000000000010100100001000011000100001100
01000000000010011000100000100000101110010000000001000011110001101110101000011000000000000001001001101
01010101010100101001101110101100000010110110001100000010000010001000000101000000001000100100010100100
10001000011000101101100010010001000000011000001100000111010000110010000001010100010000001001000010110
11000000000001001001000001100000001000101100000000000111000100100000010000001100001001001000100010011
10000000101100100001101111110011001101000000000000100000001100000111100010101100100010010000111010011
10101001010010010000110011111001010000111000010010110100100110101000000001010010100001000000100000001
00000010000000110111000001100000011001000001010110101111111010001100000101000100000001000000000100100
01000000100111011000011001001000000111101000111000000111000010011000010010000000110101010010110010010
10001011000000001000111010000100100011100001001000001111000100000000001000000100100101110100001001010
00111100000000000000000001000000101001000010000000000010010000010000011010010010000000000100000000010
00100001001000000000000100100001000000010000100000111100010001000110011011000001010011100110100000011
01111010000001000000011000010000001100001001100100001011001001000111101100011011101001000001000011000
11111001010011011101010000101000011000001010000100000001100000001011000111101111000000010110000001100
01111100000001011100000100100001011001000101101110000001000000001001010101001010100000000001000110010
00111000000110000000010010000001100000011000000000000000010000001001000100010000000000010110101110000
10010111001111101001001100010000100001001100001001001001000011100100001011010010110010001000111100010
00000000110000001100101100100100000100011100100001110000111000000100001000000010010100100000010000001
00000000010000110100000010100010010000111110101000000000101000010000100000000001010001001111011011000
00000011001100000000100001100101110000000100100001101000100000000100001100010000000001000000111110000
10011000000101100000000000000000000110100010100100010000111001001111100000000000000000000100100110000
00000110000000000000000011100011000001010100011010000000100000010110000000010000100001000000110001000
00110000001010101001000000010001000000010010010000101001000000000111000000010101100010010101111000010
00001000001111110010010010000100010010000100101000110001100000001110010000010000001000000110000000010
00001001110011111000000000000010000000100001000100001000100111100110001010001000000000100000000110101
01000001110010010001000100000000110000000100000000001011101110000000001000000000000001000100000010000
10000100100000100110010000000100010011010000000010000000001111010010000110000000000110010100101100000
11000001000001110010001010000011000000000010011000000000111111111110001100010110101010000011100000000
10100000001001101000100000100000010000011010111011101010010111011000000000001100010001110000000000010
00000000010000001000111100000000000000010000000010101011110011000000100100001000100011010001101101000
00001000000000000000000001101101000000000001000100010101000111000111011000011101000111010100010001000
00001111110000100001101000001010010010100011100000000000001110011110000010011000001110011000111001011
00000010001100000000001010100010110010000100000000100000000000101111000000100100000011000011010001000
10000010001010000100011101100000000111000010110001100000100000000111010101100000000110010000000010100
00000011000001000001010001000001101011101101100000000100001010000100000000000010000001000110100100100
00111100001010010001000010100000110001100000010000110100011100010100001001101000000010000101001001101
11110001100011000100000000100100001100000000000010000001001100110000001111110000000000000100010000100
11111000101110100000001010010000001000000001001110000100011001001100000010111011000000000010001100010
11110000000010001000100000001010010011000010000000010100100000010000010010000000011011010000011100010
11100000010000001000001101100011000001110000010000001010101000100010000000100000010000001001101101000
11110100001000100010001000010000001010110000000100001000011010100100001001000000000011100000100010000
11100010101000001000000000001010100010100100101110000100001000010010000000010101010100011000000010110
11010000100000100000000010001100100100110010010100000100011100100000000000010100001000001100010100001
10000101100100001000100010100011001001000001000001000000001000001110001100000100000000000000000010001
00000000100110101000010100110011000010010110100100001000000100000000000000000110000000101000000000001
00001000000010001000100001001000001000010000101000100000000101010000010110001000000110001001011000000
11000000000001010000011000101101011000010001000000100001000100001110001001000100101110100000010000000
00010010011100000000000000100001000010001100000000000100000000000110011000100000001111101110101101000
01110100111111111100010100010000101000100100010100001000011010001011001010000011101000000000100110001
01100001001011011000100000000000100001110100000100010001000010010010000000000100010000010101110001111
00000010000000010000110001010001000101110001000000000110100001000000110000000100111001001011110001001
00001000111101001000000100000100110101111000110000100010000100100110000000000100111000000001101000000
11100000000110110000110000010110000011100000000010010000101100011110000110000100000001000010000010100
00100000011100000000110110001001000000001011001000110000010001000100100000001001100000000000110000000
10101000001001000110001110100100101010100001010011000000000100001000100001011000000000000011010110001
00000011110011011000011111000000001001101010110000100000000000100000100001111000001101001100010111100
10000011100111100000010111100010010001100110001011001000000000000010101101111100100111000010010010011
01000001000101001010010111110011101010100111000000001001000001011111110001111000000000101110010100010
00001000000001000001010100000010100000000110000110000000101001000010000000000100000010000010100101000
00010000100001101110000000010010001111101110001001001000110011000011100011001011000001100000000001011
00101010000000000000011010100100110110000110010000010010110100010100011000000000000000100110000100111
00000000100010000000010000000000000010000010101011101100000100011010000001000001000000001100001010111
10010001000111000000000100100110000100000000000010101000011010101001100100010101110110001000000011111
01111001101110001110010000011010000100000000010010000001111000000011010000100000000000101010110011111
00111000000110000011011000100000000000000000010001000110010110001111000001000000010001100010011001111
00010011000110111011111100000100010000101001010000010100110000100011110101101010110011111100010001111
00000111000100000011110000001111100000010000011000010001000101000000110010001011111111111110000001111
