01010011000000110011101000001100000000111111010000111111111111000100000010000010000000100010000111111
00010010000010100011000111000100010000011110000001111111111000011001000010000100000000110001010000111
00010011000010101011110000000100100010111010001111111111110101001000100010100000100100100000110101111
01110010001111000001001010000001000011111010000001111111100000010001000010010010101100100010110101111
00000000100010010101011000110001010111010010010110011111110001000101000101000110101110001001010001111
01010000100001001000000010000000001101000000110000011111100011011001101100000001000111011110000000111
00001101010001101000110000001100000101100010010010011001100000111000100001001110101010011000000001111
10011111010000010010010001100000111100101001010011001000100101011001101001000000000011010100010000111
00011100010000000000000011000101010100011100000100100010010000000111010101110110011010000010000001111
00011000101000100000010001010001000000000100000000000010000000000001000000100010110010001001000000000
01001011100010010100000000000110001000100010011001000000100010100101101110000010001000100101010110100
00000010101100000001000000010001100011000001000011100010010000100000100011001000010000001001000010100
10000000101100001110100110000110000000000010000010001101100000001000001000100010100010000000000000000
00100001100000011000000010000010100010000010001010001001110101001000000010001100000000110011110100000
00000010010011110000010011000000001000110110000001000101100000000011111000100000001010000000000011010
10000011001111110000001010100010100000001111110000101000000000100000000110001000010001011110000000000
00100000011111111110010010000000000000001111000010001000100000000000101000010100010101000011011001100
10001101111000011000001110000000001011000111111001110000100110000110000000100001000000000010010001001
00001010110000000000000000000110001001100111110000000010000000001100101101101010010100100110010100110
00011000000001000000100001000001000010010001000000000100001100010000100000010000110000000110110101100
00000010010000101100010100001001110000100000110000100001001101111001000011011101000001010110000100001
00100000000010011000000000000010000001000110010100100000100000000001101010000001000000110100000000000
10001001000001001100000101000110000100001000000100111001011100100011111100010010000011011110001000100
10100010000111100000001000000001000001000011000000010100011000000000001110000001000011001100011010100
11001000100000010111000110101010100001001110001000000100100000011010011100001100000001100000000100000
10010000011100010000011000101010001001001000110000001000010000000001000000010000100001000100000000010
01000101000000100110110001101100000001000000000101000101010111010010000001100100010100000001011000001
00100010000000100010111001110000010100000000000110101101100000001010001000111001001100100001101001011
00000000001010000111110011110001000001111001010000001000001100000101000100000011001110010010000101111
00000000011100000011100100000000100000000101000000000001100000010000000011001100011101010000001001111
00001101110000000001100100000001010000001111011110100000000101011100000000010000111100100001101011111
00011111010010110000010110100101010001100100011101000010100010010001001001001101011110100010000010111
00011010010001000110001100000000010010011000000001100011001110100000000010011111010000010011010100011
01100001010010000000000110001000010001000011010010001000111101100011000001000111000001001001101001001
00000000000111010001110000000100000000000111010000010100100000000011100000010110000010001100101100001
00000000100100100111100000010101000111110010000010000100000011000000110101100001000001110001000010100
01000101000000000101010000010110100000100110100110000001000010010000001001000000110100000000100000000
01000000000010010001010100001100001001000100100000100000001100000000110000000000100000000001000100000
01010000000111001010010110010110000000000001110000000110101000000000100000101101111111100001010100000
01100001001010100000000110000010000110000001111001001101101001101000000000010000000010010010001000000
00101000010000001000000100100110000001000100110000000000111111110000100110011100101010000000100010000
10000000010000101100000011111100000001000110000000000100000001001111010111001011000010101001000000001
01000100001000000011000001000000010001000111001010110100110100000001000010010000000000000010000000110
00001001001011000001000000100010101000010000100110000001000100101010000001001101100010100110001100000
00011100110000101100001000000000100100000011000000010011001100100011001000101100001000010100000000011
00101100011011000000000010000000001000100011000001000100100101110011100000011010100010100001001100011
10000000000000000010000001010000001000011011100010011100001000100011101010001000001010000110000001000
11001001010000001001000000100100000100111001001100110000110100001111001101000000100000100000000001001
11010000110000010010000000010010100010010100010101100000010011001111111001000110111010000001000000100
00111001000000011110100000001001100000000100000010001000100000010000011000110011111100100000110111100
00100000000001000001111001000000001000110010000000010010010000001101010010110011111001101010100110000
01001001000100000000000100000000100001000011101000000000000000011000101011100111010010110010000011000
01000000000000001000000010010101010000001111100000000000100100111000000001000010011000111000100011100
01000110000001001100010000010010000100110000000010000000000100100110001100000000001000100000110000011
00000000100110001010000000000010111100110101100100010111011101010101010000001000010101100001010001111
01000010001110011000110000010010000011000100010000000100001000000001001000000011100000101000000001111
01100010110100000100001000000001000000010110110100010001011000010000000000000100000000000000001001000
10101110010000000001100110001000000001111111101000001111010000100001010011001101100001010001000000001
10000111000010100000000110000000000010010001000000001111111001000111111100000000000010100000000011100
11100100000100000010000000000000100000010010001000011111111011011111010000000110110000000111000100000
11010010100000000000110000000000110011001011000100111111110010011110000100100001010000100001000100111
00000001101000100001000011011010011010001001111000011111100000001100000010110000000001111010000000011
00010011100010011011000011100010000000000100110010000111001010001010011010100010000001100000100000011
00001001001010000000000011100001000110010001001001110111000001111000010000100100010001010001001001101
10011101010000000010011000010011110110000010000001101000001000011101000010010000100000000000110011000
01011010000000011001100000000001100100101111010000000000000000000010100010000000001100100000111100000
00000000000110001100010001010000000100001110000011010000000110011000001000101000011110010000100000011
00000000110001000010110000100101100001000100001010001110101111111101000000110001000101000101010001100
10000110000001000000000100101000000011110001000010001101001111000101010000001000101000000110000001001
00010111010101100000000110111100001011111100000001010001000001001010010110001010110000000100010000000
10110011000000100000000101111101000011110111010000110011010000000001000100000010110011000100001000011
00010011001001001010001100110010110111000100001101100000000000011011001100001000100011000100000111011
00101000111000001010000010111010010110011011001000110001010010010000100100100000100000010000001111100
00000100000000001001010100001001000100001000010010100000001001111010100100001001100100000000010111110
11000000000000000011111000110100000000001001000110010101100011000010001100101110000000000111000011100
11100001011000010111110000110101000101110100100000000101101000000000100000010001000000000000100001000
11000010000000011111111011100001000000000000000000001111101000001000000110000010101010101000001000100
01011000000000100111110000100010011000100011000100000111100010001110101001000100001100100010000010010
00111100000110100011000001101000011001000000100100110111111100111100010010000110010001001000110010000
00011000000011000010101100000000111101000010100011111111000000010000000011000111110001001000101000011
01100010010111001000010010101100111110011000101010111110010000011000000010000010010001000101001100011
00000110000100001000000101000110010000000000100000111111011010000000100011100010000010000100001000011
00000011001011000011000101001100011100010001011110011101000010110111100001100100000000100010100100011
10100000010010010000000001100101100111001110001000011101001010100000101000010001000101010010001101000
00100110010001110000001010000100001100000011010000001101100000101011100010001100001000000111010001000
00001001110101000100010110001010010010100010000000110000010010001110000000011010100001001111000101011
00111000000011001101010000100001010110100100001000000101110100100110000000000010010011000111000110100
10010100011000010011000101000100000100000010010010001001000100000010000010010010100000001100011100010
00110100100000100011100010011011110000000000000011000001010100000001000000011001000000011010001000000
10000100000001000001000000100000000000010000011000000101100110110110000001010101100110100000011001100
11010011001100000000010001001000010000010001011000010000000001001110000100010010011010100000000001000
10001000111100001000001010101100000000011000100010000000000001000100001010000000010011000000100100001
11000100001000000100101000100001001011001100101000100010010011001000100000001100000001001010001110001
11110000001100100000011010110001000100000000000101101001000100000110010000101000000000000000000101100
11100100000001000000000001100000010000011100000000000010000000010110000000000000000000000110100000000
11001000111100000100010011011010000001100001000000000011001100010010100000001101010000110001101001100
00000001111110000000110111000100001100110011010000010001000000111010100001010101100011111000101100101
00000111111111111100100111101101000110000010100100001100010000010110000000000100000011110000010010000
11001111111111111110000000001000000101010000000110011111001111000111111011000100110001111011010000110
00011111111111111111000010000000000001110010000011001111111111100000000000101000011000000101000001001
01011111111111111111110110101010011000100010100010011111111111111101010010000100100001101000000000001
