00000000000100000001000000000001011100001000110111100000100110000001011111000111100001100001000100001
00000000000100101001000000101001001010000010000011000010110101100010000111011111100100010000100000000
10000000100011011011011100111011000000111000000100101010110100001000000111000011110001001000000011110
11010000011000000000000000010000100001000000000000000011000000100010000010000010111010110010110010110
00010000011100001000110010101000110001101101000001010000101110000011101010000100100010000001010000010
10000010110000000101110001001000000000100101111010010100010000000000111111010000000000010100000100100
10100001000011110000000000010000011001010010100000110100100101010100001110001011101000000000000110010
00010110000111100101110100110000101000000000000000000101001011001100100010001000010010111111010100000
01110101010011110000000001100000101001101000100000111001000000001000011010101000011100010001111100100
10000000000111100000100100010000100011101000000101010001000001010111010000000000010010001010010001001
01100000110001000011000110011000000011110000100100011110100000000111100001001000100011001010100000010
00001101001111111010010000010000000000101001000101100010010011110010110000010000000010000010111100000
00001100000000000001010001000001000001100000010000010000100000001000001110000001000001010100100010001
00001000000011100000000000000010000011000000000000000001111000011000000001000000100000000110100000000
00011010100000110110000011100000000000101100110000100000100101010000100100101010000100100110010100000
00000100000000000010100001000011010000000000101011011000100101000100001001100100001111010011010000010
00001110100000001110100000101100011000010001000000000110000100001101100001101110010111011010000010000
01101000001001001011011001101100010000000100100000111010000101000001100011111100000100000001110001000
01010001000100010010000000000001101000011000110010001001011000000000101000010101000000000000111100000
10000010010001110000010100100000000010000011100000101000010000000001110110000100100010100100010000000
00010001100100010000110110000010100000101111001101110100000100000100000110110000010101101100000100010
00010001100000001011000100001100000011100110001010000111000110001010110000101001100000010101011000000
00010000100101100010101000100000000001000001001000001000100001000011111100000000100101000011010010100
00010100000100000100101001010101111000000010000100000000011001111100111110000001110010010010000000000
01000000001001111100101010000001000001100100000100011011001000111001111101010101001111000010010000010
00010101000001111101111010100001010000001101110000001110000101000010111100000010011110010100000011000
11010010000001101100000000000001111111000000000100011100001011010000001000010000001110000011001011100
11100001100101100000001000001000010000000001001100111111001000000010011110010010111100001100000110001
11111000011001010001001100101000000101100000010001111110000001001010011110001010011100100101000000100
11111011011001010100010000000001000010100011011000111110110010001111100100111011110000010001001000000
11010001100000010000100001100000000010000011000100111111100001100001000101001010111100000111000000000
10011000100000011010011001110110001011110001001001111110110001100000000001000100110000100001110010000
00001000000001000010000000110000100100110001100111111100010010000101001100000100101101000001000100010
10000100111010010001100110010101000100000100100001111101100100001110000001000110000010001000001010100
01110000110010000000010000000010110001010100111100111000000000011110000000000000000000011100000010000
00110110000110011001000010000000001011001000100010011100001100111100000001000111000010000101110000100
10111100010110000010101010100100000110100000110001011001011111111111111110000001011001100000100010100
00010001010110000010110000010001100000101010110100111100000100111101000100000001011100100010001010000
00010001000110001100011010000000000010000000000010011110000000011000010010000101011000000010100000100
11000001001011000000111001001010001110010010000110001001010001010100000000101101000111001100001100000
01000010100001111000111000000000001000000011010000000000010010000000010000001110000100000110010011000
00000000100000110000100010100110010100000100000010010010100110001100001100001001101100011000010000001
00101101000000000110100100000000000011111000000000111101110001011000001000001000000000111001100010111
01111000000001110000010100000000010010100100011110000000100010000000101010011100110011110101011001111
00111000001000000000000101000110010100001010101110100000011110000001001010001101100100100001010001111
10100001001000011100100110010000100000000011000110100101100010000000000000000010001100100110000010111
00100010000100000100111000011000011000100000011100100100000101000000100001000000100100011100110000111
00110000100011010000111101000000011000000010100101110010101000100000001011110000000001010001110000011
00010100000000000100011100000000100001100100001000100010001010000000000001000000000100100011100101011
00110000001001110000010000010001001010011101110000011010100001001001111000111010010000100001001000011
01001110100001000000000010000001011001011000110000000010001101100100000100111000001101000000000010111
00101000001000001001000100100011100000001000010101001011001101000010010000000011011100000000110000001
00001000011010000000010000100011000000000000100100111000001000001011001011011000001000000000001100111
01011010111000100000001101001100010101001101110000010000000010100110010000001010000001000000000000011
00000110000100011100100011111100110000000010000000000011000000001011100000010010000000110000010100011
00100100010000100001100000001111001000101000000100010000100000100010000000011000001010000001000001000
00000010110111100001101001010101000001100100110001010000100101010101100011011011010000001000100011101
00100111000001110000111000010100101100011110100001000000010000010000000001100010000001100010000011111
10000011110000000100100011000100100101010100011000000001100000001011001000100010011000000011101101100
00001101000000000010001000100000000100100111000010010110000001001000000000000100010000000100100000100
01011001110110000000110110000010101000010000000010000110000000100000101100100010001000011000001101000
00000010000000110010000111110000001101000100001111010110011001000010010000010000010011000010110000010
00011000110111000000000000010010001010000000001000100001001011110000010001000100000010110001110110001
00000011000100000000100011101011001000000100001000011001110001000111001000100010001000000000110001000
00000010010100011001100100000111010010100011111101111001000000000000010010011000011110010010100000110
11100000110000000011000100100111100010001010011100000001000000011001000011000101001100001110100100000
11111100000100000010100110110100000000010000001010000000000100011010010101101000100100010001000110101
11000011000110011100100001010010101000010110000000000000010011100000010100100100000110001001000000100
00000001011001000100001010000001111000010011010010100000000001110010000000100100111001000001010101110
01001010001001100001100100100111110010100001000000001001011010011010101100011000000000010000100100010
10000100101000000110101100110001100000010001101001010000110010010000010001001001110000110011110000000
00000000010010010110000001110000011000010011010000111001100000101000100001000001000001000111111010000
00110000000000011100000001000010001100000000000110000001111101001000000110001000101000011111110000001
11000110001001001100000000000110000011011000101100100010101010010100010001000010001000000111110100100
00010000100000000100101011100101011101000000100101000010100001010001000101001111011100000111100101000
00000101110000000100100001000100100000101010110000101010001000000100000100100011001100000000100000000
01000000101110000001110000000000000100001010000001010010101000100111100010001000100011110100000000100
00000000000000100011100000001000001011111000110000010000001110110000101111000100010001110001000100111
00000101100100001001110010100001000000010010000001010110001100010010000011000001010000000010001100001
00010001000011100100000100000101110001000010000100010110101110000100000001001110010011001000010000100
10000001000101101101101110100000001000001010011100000010101100000100101010100010001000000000010101000
00100000000001101110001100011010000000000001011001111001100001000000100010101000011101100100011000000
00110000001011001000000000000000000000000100001000010100010000001100000000011001101000001110000100000
00001100111110001001001101110010100000010100000000000011000011000000001000000111000001011111100101101
10100100001001100100000000100100001000001001000001000000011000100000011001000000000110011110010100111
00010000110100100000100110100100010000010000010011000110100000100000011000001110000000100100000100010
01000001000000000100000001000000000011001101000010010000111000000001000000000010100000010000000010000
00010101001010011000100000101011000100000000001100001000000010010000100111000000001100001000001100101
00000011101010000101101000110001110000000000100100000000111000001000010000000100011100100011000100000
11100111110010010110010001001101100111001101001101101100110000001001111000000001111100110000000000001
00000001101000000101001001101000010001010001110000000000001011001000010000010000111100010010100000001
10000001100010000100001100000010001100001000001000000000000101001100100010001000110010110000111010100
00110000011000001100000010100000001001001100001000000010100000010111000000110010000111010001111110001
00100110000100010010110110110000000001100000100000001100101000100000001101001010010111000001111000010
01101110001100100000000001010110011011000000010001010001000000000000010010010111101010000000111001100
00000000111010000000000010000001010000000100011110010011100010100000110010010111100000100000000011101
01010000100000100100001000001100001010000000100100001100010000000000011010100111001000100110010000000
01000000100010000000000000100101000000101100100100000000110001100111000000000010010010001111111110000
11101000000001001011000001001110000100010101100101000101100011111000010100010000101001100111111000011
11000000101100101001000010010000111001010000000000001111000111000001000001000011000100100111111110000
00001101111101101000010010000000000100000000000000100111010111010100110011110000100000010111111110111
