11010000100010000001111000110100100111111111110000000011100001100011000001000011111010101000010000110
00000000000101110001100000000010000011111111100010011000000000001000101010010001110010000100100000010
00011001000000010100100100001101000110010110000111010000100001110010101000010000010010000010000000000
00000100000010110100010010000000000010100001110010100110100001110100000010001001000011000110110001010
00000011010110100010100011001011000100100011111000100000010010100011010110000000101000100000100010000
00001011010010000000110000000000010100010001110001000000000000010000111110010000110000110000001001100
00001000010011100000000000111000000010110010100001010101000000010100001110001110101000001111001001000
00000111011111100101000000001010110100000110000010000010101000010000101101111000000100010010001100000
01100000011001000011001110100010000100100100110010000100000110100100011100000010100100010001000000000
00110000100000100111100110000101010100000000011001000000010111001001101010001100001100110100000110111
11101110001101000010000000011100011101001001100000011100010001010010000000001101101100101111000110011
01000101101001100000000100110110011000001000000000111010000010110100100000100000000010000011000001111
00010000111111111000001000000000000000010010010000000001000000011001001111000000000111010100000101001
00101000001111101000000010000010110110011001100000111010000110000010011000000100001111000000100001000
00001101001111001100000100110000111111000000011000000101100000000000001000010010000111110110101000000
11000001011010011000000000100100011111110010010001100000101010000010000010100100000110010000101110000
10000010000000001101000100101001001111001000100100010100110111100010101000010000100001001110001000000
00000001100000000100111110000101001100010000001000000100010001001000011000001011000100001100100010110
01101000100010001000001100001100100001001000110101011000001001000000000001101011100000000000001000100
01111111101000010011010110010000001000000000000000100000000100011000100100011111100000000000000110000
00111111000000001001000001000100000000010000000010100000010000000000000110011111100000000101000001001
01111111000100000100000000001000000100000001010011100100100010000010010001010111001000000100000000100
01111111100001100000001111001001000000010000000001000000001100111010110010000000100010000000001001000
11000000001001010011100000010100000101010000001000011011000000000011110001110111000001010001000000000
10001000000001001010000110000100101001000001000010001001011011100111110001111000001000001001001000000
01110000010110000000110001010010100111000010000010000001100000101010001001100010100011010000010100001
00010010000101011010001111100000100100101000001100100010000011011000010000000000001010010000100001110
10100000000000001011011100000001100010001001001101000111001001000110000010001101010011100000111000100
00100010010101010011100100011000001100110011110001001111100100000000001000100001000001111100101000000
01100000001000011001001001001101000100010110000010011111111001000000001100101000011000100001000111101
00100001000100110001001010000101000010001001000000000011100001010001010000000001000101001000000000010
00000101001001000110000010000011101010100000011001100101100110001000011011011001000000010001010100100
11100000000000100101000111001010000100010010000010110100000001011110101101000001000110000001100000001
00000000011010000101011010100001000110110100000010100100000001100110000100000001111000001000001010000
00100001010000100100010000011100010100110000010000001110000000001000001001110010010110100010000000000
00000101110000010000000010010000000000000001011000000111001111001001000001011001000001010001011000001
01000000001000010000011100000101000100000010000000101011110111010100000001000000001000000000000000000
00110000001000000000000001111010000111010000000010001011000011010001100000000010000000001000100101010
00011000010111000010001000010000101111000000010000000000100000100100100010110000001100100000000100010
00000100010001001100001101100100010010000011100110000010000010101001000001100011100001110010010010000
11101000000000000000100001000001000000000000110011100000101000000001000101100101000100100100010110101
11110100000101010011101010000010001000101000000100001100100100010100000011000001000001000000001111111
11110001100000000000000100010000100000100000110000011010000000000100001010010000000000100100001111111
11100011000100010010100100001110101000010111011000001001000100100000011010001001010000010001001111111
11001111001000010010001000000100001110000000010110100001000000100101000010010010000101110100001100011
01111110000000000011111101100010101100100000000100000000100000001000001000010010001111001000000100111
00000000000100000000010010001000101000010010000010011010111011000001100100000000110111100100000001000
00001100000101010101000000000010111000010101001000111000000110000000010101110010000001001000000110000
01000111100010000000000000111000011101011100010000001000000000010010100101111000001111001000001001000
10100111010001000100101110000011010010000001100001110001000110000101110111100100100100100000001100000
00000000010011011000100001010101001000000001000000111000000101000000100011000001000001001001000001000
00001101010011000010101000110100000010000110000111100000001000100110000000101001000000100100111000001
00000000000011101000010100111000000001001100001111010001000000000000100100000001000001110010000000000
01110110010001000000100010011100000110011100000100010001000001011100110000010000100000111010101101011
00110000001010000010000010001000000101000010001100000010011100101001000000000010010000010001111010011
00100010111000000100100110000011101000000101000000010000000100000000000000110000111000001000110010000
10011000000000000011001100010000000000010000001011000001000100001011000100010000001000001000000011100
00000000100100001000000010001000011100000011000000001100000100001001100000000011000111000010001101001
01000100111001010100000100010010011110000000000001100000101111000001001000000010101111100001101001011
00000000001011100000000000000000111100101000110010111011000010001010010000101000001110010010000000100
10000100001000010000000011000110011010100101110000110000011000010000010000001010000110000000000110110
10010000000001111010010101101001011000000011110000111011100011010000011000101000000001001101000000010
00000100000001000001001000100000000100000000001100011001000001100000010001110110000000101110000000000
10011000000101000000100100100000000110000000000001011100010011001101001000110000000000001000001001100
00010001000100000010000000111010000101110001010000000111000100100000100010000100000010000000110110000
00111000011100110011100101101100001100011000011000000000000001000001111100100000001100100000010000010
00111100000000000010011000101000000000010010000000000011000100010000000000001110100101111000000000000
00010000011001000110100000001100010110010010011100001111101001100101101001000001010101000000111100101
11000011000010100000101101001000110110001100100000010011000000010110001110000010010100100110010100000
11010100001000100000000100100100010011000001000000100000100011010011010000001000100110001001000000001
11100110001011011100000111100000000000100011100000010000100001000000000000010100010001001000101010100
01000010110010001000010110000000000001100101110010101000100000000000011000110100100111001100100001000
00000000100100000100111000000000100101000100101001100001111000011011001000110000100000101000110101000
01110001000110000011100010010000110010010001100000110010000100010000110000010000100100000001000110010
10100011000100011000011000100001110010000000001010100000010001010100100100100001010011100010010100110
00010100000010000000011100010100100001110000000001010010001000000101001010101000001000011100001101000
00000010000000011000000100001110000001010000001000000010000010000010101000000001101000001010010100100
00110000010000110001001000001010110000000100000001001000000100000000100000000001111101100000110100000
10010001000110100011000100010000100000000001100000001110110010100011111100010001100110000000100011100
01100000000100010100000100000010100011000100110000000000000010100000010011101110001100101101010000010
00011101010100101001010100000000000110000100100001010010001001100001100000100000111101101010000000001
10100001100000100010000101111110111000010110001000101000110101011100100100100110011110000011000011001
00000010001100011001000000011100011000000000101001001100100101001000110101000000011101010101101011111
10000000001010011111001100101001000011001011011110000010110000100000001001001000010000100101001001111
00000010111001001110010111000100000010101000011100101001000001110010000101001001000010000000000100111
11110010000010010100010001100100001010100000001000001000001000111001110000100011000010001000000000111
11001100011010000001011001100010000010000001011101000001000100100001100001110001010001111100001101111
11100000001100001101001100100011010100010010111100000010100111010101000100000110010111101001000010001
11110010001101110010000101000100101100000000111000001000010100010000001100011100001111000001001001000
11100100000101100000000000001001100100011100110000110110000100011000010010100000010011100000101110001
11000110101110000011000000000000101100001111000011000011000000010001001000001000001011010000100000000
11001011000010010011110100010110001110000101000001001001100010001001011010110000000000000100011010001
11101001000000100001111000000011000100100100100000000100101000100011111110000100000100000110100000001
11110000001010100001111011001000000001001110000000011000001110100111001001000000100010010011000010001
11101100010000100001110000000000101000100110000000000000000000010110000101000000000011100111100000111
10001001100110111000010100010001111001000000011110001001000000010001110100001000011000010100000000000
10101000000000000101000101010000110100000010101000101010000000010000000010000001100000010110100010100
00001011000000110100000000001100000100000001101100000001101000000000110010101000000000101000100001111
00010000010000001000010001000000101000011111001001000010000100001011010010010000000101001001110000000
00001010110110110011110010011100111010010101000000000000000010001011000010011101000010000000101000001
00000000000001100010000000110000010000000000100100000000110001001010000010000011110110100000000001011
