11100100001100110001110010110011110000110111000010000011000000111000110100001000000101000000011100101
01000100000000010011100000000101111000100000101011010000000101110000000001011000000000000000001001000
00001001010010000101100000101000010001100101000000000000010001100000010100011000010000111011010010100
00000100010000000000100100110000000100000000100000010110000000000010110010001001000100000001001000000
00001000000010110001110100001111000000000001100000000100100001010101000000001001110001100001101001100
00000000010001110010111001000110000000000010000101000101011000000000000001110001001001000101111000100
11010001010000010100110001000110000100101001010100100100010011001101111011010000100010000000110000011
00110100000000110000000001110000001110111100100000010000001000000100000100000000001110010011000001000
01010000000101010010111101100000000001101100110001000010001101000000100110100101000000010000000011000
00011000000000000000000001000111100100100101000001011000000001000011100000000000000000000010010110100
10000101011011001000110111010000001001101000001101000000011000010001010010001100100010000001000000110
00000010010001001000100001000000000101000010000001001001000000101110001010100110100000000000000001111
00101000010100010001000000100011010011010011111010100001110010000000100111100000000001011110000011111
10000100010000010000000011000001100000110000000100010000010111100100000011000011100011111110001111111
01100001001000001000101001100100101000001000000100000000000010000101110000110001001001110010010101110
00000011010000110100011000000001000000000000000001010011010000100000000010110010000110100000100001110
00000000000010000100110000000100011000000000011000000010010000100000000010001100001000110000001000000
00000100001000001001100001010010001001100000010101000000000000110000001001000100000000000010010010100
00001010010100101111000010011000000000110000010110001011100100010000010000000100010100001011010010000
01001000000110010001000111000101110000100000000010000000001010101001110000010000000010001010011000010
01011010000001100101000110100000000011101010000000001001010000100000000000001001000011000100110010000
00001100011000000000000000100000110111110010100111110100110100001000100000110111101110100001100000010
01000000010000010000000010001000100011100000000110000011001000011000000000000000001110000001000101010
11101010110100000101110010110010000001110011100101000001000001001101010000001001000100011101100010011
11001011000001001000000010000100110110000010000000100000101000000000000100000000101011000000000101011
11111000100001010001011011001000000001000000010100000010001101000100001001000110001000000011100001011
11111100000110100110100000000000011000100101000000000001000111110110010100010000010010000101000001011
11110001000000101110110100000100001010001001000100000010001111000000010000000001000010110000110000000
11111000000101100100000110100010001000010010001000000101000000101001101000110100100000000011001000100
11111001010000101000110111110111000000000100000011100000101000000101100000000010110100000000000001100
11110001000111000000100001110000000000000011001001000100000101111100110001001110101001000000000001010
11111001000000100101100011110101011100111100000010010100110010000000001001001111000000010110000010000
11110100000000001100100001100000000111000010000110000000000010010100001100100010000001001000110101110
11100000000000111001110000011100010000010000100001000001110110100001010000000010000100000101100001000
01101111001001000000000010001101001101010011100000001000000001110000000110001000000000011010101000101
00001000100000010010000000000010000000100011111100011000100011111110101000100010101000110010000000000
00000001010011000010010001000000000100000111111101110000000001111000100001101000100010110000010001010
00010000010110000000000000000100000000001001111000100100001000011000100100001100110000010011101001111
10010011001111100000110000001000010100101001100000000010001010011000100101000001010010110101100000000
00110001000110000011100000001010001100010011000001010010000010010010101000000100001111011000000001000
01111000001001001010010000010001010001000010001011010111000100001110000000000000000010011001100001000
01111101001001010000000100010100000100100110110010100111000011001101011001000100100100001000000010000
00110000001000000000100000010100110100010001010000000000111000011000101011001100001001111010100000010
00100110011000010001001000100111100100111110001100100000111010100001000000100000010001000000000010100
10001110011100000000010000010100000001010001001100100000011001100000010101000001000010000110000000010
00000111111010000010001100011010001011000110000011000010010001000010010000101110110100111000010000001
00011111110000100001000101001000000001011000000100000001000100010000001000011110110001000100100000000
00010001111000100000001000010010100011000101000000000000001100000110001110011010000001010010100000000
00000011111001000010000000000000100000100000100101100010000001000001100100010011001011100010100110000
10100111000000001010000010011001000001001101000000000100010011100000100000010010100110001001110000110
10010000101000000100010100010000000000011000001000100010000110010000111100010000000001101011110100001
11000000000111101000000000000001011001000000000010001010011000010010001101101001000100000011001100000
10001000110010000000000101000000000000001000100000011101100010011010111000100000000001010000010000000
11100010100000000100001000101000101101001001000010100000000010000011111000101100101011010001111001000
10000010001100001000000010000000000100011000010011110100010111000111111101000001000011111001010000110
10100001100000000000010000101001000010000000110001000000110010000000100000101000000101111100000001000
10000110001111000110000000000000000011001000010000100000000111100101000000001001110000011110001000100
00010000011000110000010111011100100110000000011111000010011000010110011100011001000100001110000000010
00000001100001000001001010010010000000000100111110011000100000000011101100000010100010100010101111011
10010100100100111000001010011001110000000100111000000000000000000010000000000000101000010000101000011
10100010000001100000011000011000011001111001100000000001001100101000000001100100010000000001101011100
11011000001000001000111100001100010100001100100000010000010001001000000010000101010001100100000011101
11010001100001001000101011011010000010000001010000001100001000000001000000100000000111000000010011000
00000010010000010001000000010001001000000010011011100000010001001010001111000011100001000011100011010
01001001000000011100010010100010000000100000100001001111000100000000101010000111000010010001010011010
00000001000100000000100001010000000111000001000001010000010001000000100001001010100001100110000101100
00011001000010100001000100000100110000100100000000000011100000011100000100000000100110001111001000000
01010011100111001110101000110110010101101101110011000000010000100000011111100000001010110100001010000
10000101010111111010000001100000011111110001100001101011000000010100101111110001110000100000010000000
00110000001111010010000010010100000110110101110110011001001110110100000111111110000010000101010000101
11001000000111000000000101000000001100000000100101000101000100011000000011111000100110101110001000000
01000000101110000001000000100000000010101000001000000000000001001000010111110100000010000000100000000
00000000000100000000000000000111010010101001100000000100011011100000010011010001000011101010110000001
10001010111100000110100000110100000000010001010000101000010000101001001011001110001111001101110000000
00000000111110000000000000011101000110110000001101100000001000000000100011101100000110000000011010100
10010011000010100100001110100100000000000000000000010010001111011010010011100000000100101000000100000
00010010000001000000000001101010100000000000101100000010000000000011000110000000111100100001010000011
10010100000000000010101000100001001100100001110110010000000010001011000010000010111110011101100001000
10000100000100000000011000000010010010100000000001010010001000001010001010100011010111001001101100001
01111100000101001100010100001001000000001001000110000110110010100000000101000110010000000000000001100
00010100010000011000000111011100010000000001000100101010100100000000000000000100011001000101110101101
10100001111100000110000000001010100111001000010001000001000100100000000001000100001001010000000000011
10000000111000100000000000011000001100000000100101011011010000001000000010100110010000001010110000000
10110001111000010000110000100010110110000000010101100010011000000110110100010000100001110100001000100
11001111000000000010000000000001010010010010010000000001000000000000111100011010010000000010100001000
10000011010000011001000010100111000001010000010101000100001001000000010000101011010000100100110101000
11110100000000000010101110000000010001001100100000000011000010101101100010000010010100000000000011010
10000010000010010000011111111110111010001110100010010000000000110011100011111000001010100000100101000
01000111010000000000001111111001110100101110011100010000000100000111110001111000000000011000010000100
00000010101000100100000111111100100010000001000101011011000110001000011111111000000010000010001111110
00100110100100100001000111101010000000000000110001110101001010000000000001111000000010000100100000100
00110110001110001010100010000001100100100110100000100100000000000000001110000000101010001100010110000
00000000001000000100010100010001010000000110100001110000110000000101001100110000000010000010001000100
00000100000011010011000101000100000000101111100010000000100000010011001111000001000010000000001000101
00010010001010000011100001001101110000001111101101100001110000001110001111110111110001011111110101001
01111001100011000101100001010110100001101111100000000010111110010010000110011111100100100001000000000
00010000100000010100001000010100010001001111000001000010010000011011010000100100100000110001001111000
10011000001000100010101010000010100111000111100111110000001000000011110011100001100000000101100010010
00000000000000011100001100000010000010000111110001110010001001010001001011000001000001001001000100100
10010110100000001100101100000110000010100111100011010000000100100001100000001000001000000100100000010
00000001110000000011101000001111110001100011111000001000100000100101001000000100101000101001111010111
