00000000000011111011000000000011101001000001110000111000000111111000000000101011000001100110010000011
11000000010001111010001011010011100000000100100000000100001111111100101110000000000100100100000000100
11001110000000001001100011100101000011001010001101000001100001101110001001010010111000000000000000010
10100111100001000100000111111000010100101010011100000000101000000111010001100000000000101001110101000
10001000010000000000010001000110010000110000001110011000000001000010000100000001001001100100001001010
00001000000000100001011100100000000000010000101000000110010001000010011000000100010000000000000110111
00010000010010100000001000001000110111001001000001100100001001011000100011101000001000100000010000000
10000010001010100000001100010000001100000000000000000000110110000000010000000011100111000100110000000
10010001000101001110011101100011000001100100000000101000010010010001010010011001001010110001010000101
11111001000001000010000000010001010100100010100100101100010001011010000000000000011010010110000000001
11011101010000001010011000001011101110000001100000100101000100100111111111011001101000000010001011100
00001000001000100100100010110010000000000101000001001000000001000000000111100100000000000111001000011
00000010000111100100011000100000010011001001101100110001100010011100100111000001001000000111100110011
01001000000000011001000000110001010100000100000101010001001000001110011110001100000000000101011010011
11010111001000001000000000001100101000010000000000010000000010001101001110001010001110101100010011001
00110000011010011100001000011100100001000111000010000100000011001100000111100010011000000001110000001
00110001100010111110001010001000011000010001100001110000101110010000000011000000000010100001011111000
00001100011000111110010000110010100000011000110111010100000000010101000000000001011100000100010000100
00111110001111011001110100001001100000100000101001001010000000101110100000010110100000000000000110010
00000011010000000100111100100000000000000000100001101010100011000110101100010010000011000001110000011
00000101100000011010000010011000100001011101100011100001001101001000101001100001010000100100000010000
01000000000001011001000000001110001010111111000011010100101000000100010000100001101101111111000001100
10000000000001000100100011010000011100000100001000001000100000010010000001001110000000101111100010100
00000100000001101000001100101000000001100001000010000000010001000000100000110011100001000111000000000
00011000000001110100010001001000001000010000100100100010100101100100100110010000001101101001010001111
00001111000100100000110000000100100100011000000100011000011111101000010001110000000010000101110000001
00011010011100011110001100010100001000100100100100111100100011111010000100100100010111000100001110001
11000010001011000001011101100001000000110000100001111110000000100000010100011110110111010100011010011
00010100000011100001101000100000001100000100010010101000101101100000000010111111000011011110000000010
01011101010010000010101010000000110110100001000100001100000110000000100000010010011110001100100001000
11110100000010001010000001000010000000101100001001100100001001000000000000000100001111001010100001001
11000000010100001000000100010000000110000001000000100000000000010000010000000010010111000000001001000
01000000000101000010001100000010001000001011101010010000000100000001100111111100100011010010000000111
00000010111110001001100010000111000011100001100010000000110000100001000000111110000000010111001010000
00110111011100000000101000000010010000000110000100100001110010001000000010111100011100100010000000001
00100001001110100011000100110100011101000000101001010000001010010101001100001111101000000100001100000
01000010001101011110110010010001100000001000010010010000000000010000011000100110000101010000000010001
01000100000101010000000000111100000101101010010010001000010000000100000000010010101000101011000000110
00000100000000010100000001010000001000000000010010000101001000000001101010001000100100000000000100000
00001000000110010010111111001110000000100111000100000000001100000000001000100000100011000001100101010
01001000010000001110110000010011000100000111001000011100000010100111000010000000110111001000000001100
11000000000000010001000000000000010010000000000001110001000000001011111011110000000111100000000101110
00101000000111000100100110001110000101000101100010000000101001000001100010100000000110000000000100110
01000111000000000000100000010010000000000111010110011010000100000010001100001000010110101000001111110
00011001000000010111001000100100000000000000000101110000001000100000000110100010001110010010001100010
11000000101000110010000000010000001000111011000000100110010000000000110111000010101101001100000000010
11000000001100000000000001111000100000001000000110011000010100110001100110110010111100100100100000010
00001001111100000110000000110000100100000101100000100000101001000110100010001100000000000000100110100
00101000000110010000000000010010100000101000011000101101000011000100100110001110110100000011100100010
00100101011000011010001000010000110000100110011011100101001000001000000001000000000010000110000011100
00010001010000100111000010011001100001000000101010000001111110100000100011100001011010000110001110000
01110101010011000011011000010000100011010100000001000000001100001000000011010010010001100111101010110
11000001100010000000000110000111010000100100000011000001110000000001000100001100000000001010010001000
00100011000001010010010000100010000010111000111000011010010010010110000101000101000001001000100001001
01101011111101000100100100001100010100110000101000000000000000010010010010000001101100110000000000000
01110000000100110001110000000110101101110110000100001011100100001001100010001010000000100100100000100
01010000010000000000000100000001000111111000000000010100001000010000010100010001000010100000110001000
00000100000101011001000000010011000000100000010111010000100101000010001100010000000000010010001000000
00100000100011111100110000010000001001010101001101100000111110001001101110110100010100000000010101100
01000010000011111110000110110000110101000001010000001100010110000000110110001110100100001000000000000
00100010110101110000000000000010100000000000100110000011010101001000000110100111000000100100000101001
00110110000000110100000000000010010010010100001010101000000001011000001010001110001100010010000000101
10000101010111001000101001000100000000011101010000100110101001111000001000100100000001000001000011000
00100001011000001001000000111100010000001000110000000100000110000100000000000000000010111001001011100
10000000100000011111010000000110000100101010001010011000001110000100000110000000011110000001101000000
01000000010101111110000010100010100001000001011010000010110100110010001001001000000010100110000010001
00010011000111111110110000000100001000100010000010011110010100000000111011000011101100010001100100100
00000111000100111101101100011000100010101000000001100101010000000011001000000110101000010000011100000
00001111000001001101001110110000010000001000111000000000101101000000100001001000000011001010011000100
10110011000000011101100010111000011001000000000000100101100101001110100000100001001000000000000000001
00011000010000010000000000111111000100000001000011001101001001100010010101001000000011101100001000001
10110011101000000000100011001110010100001001000111100110010000000010011000100010001001110100011100010
00000011100101000001001110011100000011100010010000010000010010010100100000000000000000000100010001010
00010001101001001111010000111001100100100000000000000000000101010100100000001001111001100000001000000
00010000100111000100000000000110000001100101000010110010111000110101111100100000001000000001100100111
11000011110000000100000000000010000101000000001111000000010000100111101110000000000001001010000000000
11101011111001000000100000000010101100000000000010010000110010000000000001010000110010000010011010001
11000001010001001110000001010100101100010000100000001000000000000000000101010011110110011000000100011
10000010010100000011101100000000100000100100001010011110001010000000100000100010100001000110010000000
01100000100000110011001100000001000001110001010001000001000000001011110000110000001110001000100000000
00001010000000000011100011000000011010110100000000000100000000001110100100010000001110110010110010000
00001010000001001010110011001010001000100000011101010000000010110100001000001000001101000100000111000
01000000010110001000111010110001000001110010000100100100000110100000011000000000010000000110010110011
00110010010000000000110010000101101000000110000100000100110101100000010011000000001000000110010000000
01001010110000101110001001110100000000010001010000001000000000101010000111010010010010000000100011001
00000000000000000011101001010000111100111010000010001010100101000001000000000001100011000000000001000
01000100100001100111000000000000010001100100111110000110000000101000000001000100110011101000101001000
10000100010000100010000000011000100100100110000001000000000101110000010010001100001001001000100000000
10001000111101100100000000000000001001010000000001001010101000110010100100101101000010011011100100000
11011000011110011000001010001000001000001010010001010011000010000000100100101100101011000100000101011
11100010011001001000001100100000101001000100010000110000000100110101110000100100100000000000011001011
10010000000001000000000101001100000111000101100100001000010001000000001000000000001000000001000100001
00100000101011011000001101100111001000000101001010000001010000000110100000010010010010100110011001101
00110000000000001010001111000000110000001101010000011100110001000000000010000001001100101000010000110
01000010010000000011100100000000010000000000101010001100111100100000100000000000101111110010101000000
00000000000110000010001000000100001000001100100011000100010000000000100100000100001111111001000110001
00001101001000001110000000000101100110000110000100100100110100011000001001001010101111111110001101011
11100001101001100000000001110000101100010001010000000010000010100110000101000001001111111111000000000
11110001011010000000010001000010101000000011001100100011011001001010101000100001111111111111100010000
11100011000000100000101001000101000010110000001000000000011000000011011110111001111111111111111100000
11110100010100010100100000010000000100001000000000110001000001001000011110111101111111111111111111010
