11000010000001001100000101111110000010100000001111010000000010100011110111110100010000000010000000010
11001000100000000001000000101101000010010100000010000101000000000000100111100000100000010010001001100
00010000000000000001101100000100000001001110101010110000100000010010000111110000000000000000100010000
00100000110000000100010000001100000000100110010000000101110100100100011111100001110100000000010000001
11000010111010010000100000011111001011101110111100011110100000001100001111000001010000001010001001001
11000010010010000001101000001000011110001111000000000100000001001111011000000110000000000011100000100
10101001011001000100000000000010000100110111010101100111010100011001000000000111101000000010000000011
00100000010011110101100000000000010000100100001000010100010100000001011100011110101000110100100001011
10001110101001111010000010100000010100000000000000110100100000100000010000000110010011011110010000001
10101100100010010000001001010100100000010010000011111111100001100010000100000111000000011001000100001
10010100001000100010010010010000000011101000101111111000111000000000000000000101000000110000000001110
10000100010000001000101000101000001001000000000001110000011000100110000001100001000011110100100001000
00011000000001000000100111000000000000000101001000101100000000100100010100000001010011100000100000010
10001001001011110100000000000001001011001010010011101000000000001110100000000000001001011010011100000
00101000100100001001011011101000010101000000001111100001101000100010101010001100000000001110000001010
11100000000000000010001111100000010001000000110111111100100000000010100011000000100011001011000001110
11100011000010101110110000101000000101010011000111010000001100101000011000010000010000001000000100001
11000010010100100000010010100100100001010110001111000000000100000011111011000011100001000010000010100
11101011010100001000110110000000110001001111000110000000000001000010111111001010001101101111000000001
11110000011110111100001000001100100001001110000000100000100110010110111111011001010101001111101110101
11111011000010001110111001000101001000000101001001101100001100010000011111001001000101011110001100011
11111000001000001111000000011001110100111001000000001110010001000000111110000010000011000011000011001
11111011100101010100000000100000100100100011000000100100100000010010101110100000010000100100010000100
11110000001101100101000000011000101011000010001001100101100000000001000000001100100000010011000101010
01100000001000000010010011000100100000000010001011001010001000000001001000001010101000000001100000000
00001100000100001000001000001100010100000000100001000000001001011011100000000010010001100001000100000
00000000000001000000011000100000011101110000110000000000000011011011100101011010000101000101000000000
00110100100010001010000001000100010000001100010000001000000100000111110000100000000100010000000000000
00101101000000000100100001011001010101000000010100000010000010000111110000000010000000100110011000011
00100100010000001000101000001010100001000000000010100110101111010000000000000000011100100110010001010
00000001100100100001001101000100010001100100010011001011000011000100000110011001010000000010000000000
01100011101101110001000110001100000000000101001100100010110000000001101001000010010000000000111010100
01101000110000001000100010001011001001010111011000100000000000000001111100001000000010001000111111010
00101100000000001000000000011000001101001111000010100000000001001100000001001000111100011000111110000
11100111111000010000111000101000000000001111110100000110001001000000000111010000101010100000111111010
00100000010000000110011000001001000000000111100010111110111110101000010000011000100001000000111110110
00100000110100000100100000001001001010001000001000010011000010000110110000000001001101001000011100100
10000001100100000000000000010000100010100011100000100010000011000100011000000111100010001100000010010
11110010000101011010010000100010100010001010001000001001011010010000100100010111100010010011100000010
11000000110011010000010100001011111100100000001000110010001010010000000100000010001101100000000000001
10010100100100010101000010000001100110110100000011001000100111000110000111100010011100011010100110000
01000000010000100010001010001100001010110000000100100000000100000000100000000011001101001001001000000
00000000111001010101101010100101010000000000000001110010000000001011100100001001000101101000001000100
10010011101000001001000100000101110100000001110001100000001001000000000101000000100000001101101000000
11000011000000011000010100100100000001000000010111101010000100010010100000101000011000000000000000101
11001001010001010100000001011111100100110000110101100010010110001000011000101001010000000000001011101
10000001101010010010000101001110100011101100010000000001111000000000000000110000010000101100100100100
01001000000010110000001111001100100100101011001000000100001000001000001000000001001010001100100110001
00000100000000011000100000000000010010001001010000110001010110001000100110100111110010000000001010000
10000011000110001100100001100000011000111000100101000000100000111111011001010001000101001100010010000
11000001110011011100011000001100111111010000000001000011100000100100000001000000010000101000010001110
11000000100111000000101000100010010100000001100110000000110001100001000100011000111100011100011000000
11010000010010000100000001110001100011110010100000000110010000110010010100110001111010000001000000000
00010100111010001101001000100011000101100100110101000010000100000000110100100000100001001100000010101
00000001111011101000100110100111010100110000000110000000001000010101000000000001000011000010000001001
01000100001001011100001010110011000000000100000100110101000010010000010000000101000010000001100110001
00101000001100000000000000001100000010010110011000010111000000010010110110000001010000000011100011000
00011100000101000110100100100000000100110110001000001001110010101000000011000111110001000001110100000
10111110011010000101010100110000010000000000011100000011010100001010000000010000010101000000100010001
11111100000001000000010010100111010101001000001010010111000100001111101000000000000000011000011001011
11111000000000010111000000000001001100110000001001101000110010010010010100101100001011100000100100110
11110000001000010101111000011000000010101100001001000000000000000101000110100000010011010010000001000
11111110010010000000001000111011000000100010010100000110100000000000001000001110010100000010011000000
11100000000100011100000011111000000100001000000110100010011100011000000011100000001110010000001010000
11110001001000110111001000011001000010000000000000000001001100011000000111000000000001010001001000000
11111000100000100001000100110000000000001100100011000011000000010001000000100000111000101010001000000
11111000000000110100101010001000110000010100110011000000000110101000110001111010100000001101000100000
11110000101001100011000000111101000100100001000010000000010100001100010011100000000110110001010000000
10000100000100010000011000001111101000000100010000100010110000000010000001010100000001001001000100000
00000101010000010001000000011100000000100100100010000000000010001000110100000000100000100000000000100
00000010000000000000101100011100100010101000010001000000010100010001000111010011010010000100100001010
10011110100000000001000000001101001000101110000000001000000000011001000100000111000101101100110100001
01100100010000100000001001000010000000100010010110000100001000000001001110001111001000100100000001011
00000000110111000010001001010000101010010000001101110011100101000000100001011100010010001000110000000
01001000100000000001000000000110001001100100110100010110000000000011100010111010000000001001010000011
00000000000100110010010000010100010000010000000000000001001101001001101010110000110010001000000000000
00001000100000100100110000101111100111011111000010001100000100000010111000000010000010110010000000110
00001011110010100000000000000101100000101011001001000000000011010110000000001010001010110110011000100
11000100100100101000001110010100000010100000010000111010000000000000010010000001011101111001010000000
11110110110000100000000001000001010010010000010000010001010000010000011000001000001001000001000001100
11111100101100000010000110000000010110111101100100001000011001100001100100011101000000001011000100000
11111100001000010010110000001011010111110010001000011001000010000000000100010000000000001000010010000
11111000000001000001100100000001011110010100000100000000010100000011111001100100000100000001000010001
11111101110110100100011001001001011101000011001011100010000001000000001010000001000001000000001010010
11111110000000000001000000001100111000000000011000010000010001010000000000001010101101010000111011110
11111110000100011101000011010001010001010100000000001001000010000001001001010100000110001110000100000
11111111101000001010000010010000010100110000001100000001101000000000001001000000100000000000100111000
11111110010100001000000010101110000100100000000001010110111000110000000010000010010100001010000000000
11010100100000011110100100100010001001000001001010000000001000000110000001001000010001001111001000001
10000101111001011010000000000001001011110010010000001000000010100000000000000100110100001000100001011
00000000000011100001000100010000000001000000000011000111110010110000111001001100011110001100000100001
01000110000001011001000001011110000100001010110111001111100000010010000100001000100101000001010000010
01010001010100000000100001110100001110100110110001000111110010001000000010000110000000001100001101010
00000000010011000000000000000101000001110100010001001011100000011101010101100010000010010000100001100
10010010100001110110110000001110000000001110100100011000011010011100100100100010000001000011000100001
00011000001000100111011001001110101000111110100101001000011010111001001001010010010001010000010100011
10000001101001111110001001100000101110011001000001000110001100111100000001001000001010010000000000011
00100010000010100010101101111000000001111010000000000010010001111111000010001001000110101000001010001
10010100100000000101100000001000000100010001100100011000100101111111100000000010000000000000000001111
01011100001010000001000100000100001001011100001000011101101110111111101000010000100010100000010100111
00000101010000111111100011110101001110000101101111111111100000011111111101011010010110110011001100011
