00001001010001110111100111000000011111100100000001000000000100010110000101111100000000100010000001011
01010000001000100011000000100010100111110001101010011000000001100011100000110000000101001010000000001
00000000000000000001101000111001100001000000001000000100010000001101000010100101001101000000000000011
01000010000010010101001010000000100000100000001001000000010001100101001100001000010000100000010010011
01110011010000010000000100000000100010000000011101011011001010101100000001001100000000000000001001101
00011010000001000001000101000001111000100010010001100000101000100000000100111000001000000000001000100
01001100100100101000110001111100001010100001111000000100001000100100001000000011000000001010000101101
00010010000001111100001000010100001000000000010001001000010000000001101010001110010010110000001011000
00010010110100011010000000100000001010010100000000010011011000001000001001010000100000111101100010001
10001000000001010000000000110010100011011100010001010000001110010000010010111000000100010000000000000
00100000000011100000000010100000010100010011000010001110101010000010000000010000001000111010011010001
01010000000111000100100110010110010001010000100101010000001000101000001000110100000000010001000101100
01000101001110010000101100001000101110010100000000100000100000100100101001000001000001001100000101000
01100000111111000100100010000000000001010011001110101001000000000110001010011101010100000011100100100
10001001000000101000000100001110000010001000100010000000100010000110011010001011001000100011100001001
01000000000100011100010010000001000101000001000100000000000000001101111100100000000000010000000010010
00000000000000001010110100110000010001001000100001000010011000010000001001000000101100001110001001000
10000011000111000001000001101010110100110000110010000000110000010100000001110100000000001101110100000
01000100000000000010100100000001000111000101000001100000010010000101000000100000001011001001110100100
00001000110000000100111000001000001101000000001101000100000010000001000001001001011010011011110000001
00000011010111110000001000000010000100000000101001101010000000000100000100011000000001000010010010101
00101000000000000100001100001000000000110111100000000000000000011100100000010000110000000010000000000
10011111000000100000110000011000000000001110010100010101110000101000000000000010100100001000101000000
00001001010010000100001000010100010010000100000101101011001000001110100010000010001101001010000000101
01000100100000000001011111110000011011101000011000001000001000000000000000001011101000100001001101010
10000001111011011011001111110000001000000001000100100010000000001001011000000010010111000100001000000
10100100010100100010100010000000001010100010001001000000011011000010011000010111000010111000010000000
10010000010000001000010010000010110010000111000000000001010000100100011100000111000110000000000000000
11001011010000010000000100011110100100100110010000010000110000010010000000010010011001000000110000011
00010000001111111000100001000001111001100101010000000000000100100111001100000001000000001000100010111
00110001010010111011100000011000000001101001000010000001000000001000100001000000001110010001000001101
00110000010000000101011000100010000000001000110010100010100111001000000101010001010100000000010010000
00001110000000000000001001000011001000000001000000010100000001010001100000010010010001000101011000101
00000000001000010000000100100010100000000000001010001000000111100001101101010000000001000001100100100
10101000110000011000100000000000000101001000000010110100000001000111100000010000000000001000100001000
10001000000001100010101001000000110000001101010000000101000001100011110001001001001000000000000010010
00000110001000101010010011011000000000000001000001010001100110010001000010010110101000110001100001101
00010101010000000001100000000001000010010110001000001100000111010010000010010110010010010101000101000
00010000001001100000100010100110000000111111001100000001110000010001000100010000110100000100000110000
01100000011010010001001110000100110000010011001100101101001000010001001010111000000101001000000100000
00000001010001001010000100010000110111010011010011010011000001011100000000011010000000001100100100000
00001010000000001101000000000110001000000000000100000010000000001111011100010000101100011110010101010
10010011010001010000001000010001010000001100100100010001000001001000000001001000011101011100000101100
00011000000001000100000100000000001110100000000110010001100011010000001001000000111110000001100100000
01100101000011001110010001001010010000010000100010000110100110110001110000000000011110000101000001111
00101000010100100000100000000010000000000001011111100000000000111101101100011010010101001111010010111
01100000100100100000010000100001000101000001011101011010000001100000001110100100000000000100000010101
00100000000000101001000010110100000110110010001001001111101000010101011100000000011000010011100000101
10001100001000000010010001110000011000100111000100000100001000011110011010000111000001000000100010000
00100000001010011000010100100100000001000111010001000000001000010101000000001111000000010000000000000
00010110101000011000000011100100000000000000000000100011000000000001110010110000000000000000000000000
00011000001000110000100111110000000100100110000000001100000010100000000001010000010000010010100010001
00001000000001100010010111101001100001000010010000010000000101001010000100000011001111001111000110000
01001000000111000101001001000000000100000011001100010000010000001001110001001101000000000011000000000
00111011001110100100011010000000010000000100001000100010001000010011001100100100010011000110010001001
00100000100000001011110011000000000000001000010100000100000100000101100001001000110100000000100010100
00001001110010010010000000000000000101010111000000000011110000000000010100111100001001000110110000000
00000000110001000100010100000101100000000000000000010011000000100110001001100000010000100100000100010
00100000000010000010001000100011000000110000110010110000001011000010011001000000000010010101000110000
10100000000010000101011100010000011010000011001100100010110000000000001000001110000011001000000011001
11000000011001101000011110001010010110001110010110001100000110100010100010100000000000000000101000011
11000011111001000001000101101100010010001110110001000110011010101010010010000010100001100000000010001
11010000010101010001100000001010000000100000010100101000000000000010000001000011000001111101000100001
10000001000000001110100000001011001000000010010000000000100001010100000010000000010000100101000110010
00000000001000000100010000000001001010010100000010010010000011100101000100000000010000000000000000110
00100100000000000100001001100111110001000001011001011000100001100011000101001100001010100000000000010
00001110100111000000010100100001010000100001000010001000101001001001111000100101000000001001010001010
11000000001010100001100101101100011001000000101000001000010000010101001000110010111010000000000000000
00100110001000111001100001001000110100010001001101011000010001100100010100000010000001000000000001011
00000010100101100000000011000101010000000001010011100000010000100000010010010011010110011100000000000
10011001110000001010110010011000000001001000000100110000000011000000011001000110100000010111100010100
10000011000000000010111100010000000000101001100001111100010111100000000000011110000001000010000001000
11001000000100101000000101011000000000010001010001100110111111001000000000011110000000010010000000000
01000011001000100000001010000011110100111001001110000010000110001010010000001000100000100100011000011
00001000110010010001001010010000001001011101001000001100010000001010100000000000001001010001010000111
00010000101001010100101011100000001100001100010001000001000000001100001000101001011101000011100000100
11010001100011011000000010001000010000100010110000010000010000100000011010000000010001100001100000001
01100000010000000000110010010010000110000000000111001010011000100000000100011010000101110001001011100
00110110010111101011111111000000010001101001100100000000001100100000000011100000010001100000000000100
00001100011000100100100000001000000100000000000000000100011100000010100011100000010000001000100000110
01100011110010000001110000001000000010011000000001111110001010000000000001110000010100000000010000100
10000010000000100000101000010000001111000010000100011000001000001000011000100000000001100110010111001
10001001000011001000000110001010100011111000101110011110010100100001011000000010101011100010110101000
10100100011011001001110000100000010111100010000100001100100010000001000000100110000000000001110000001
01100010000000100001110001000101101001110000101001110001000000100000110000001010010001100000000011001
00000000000000010011110000001010000100111010000011100000011001000100110100000010001110000000001001000
01101000001110000011110001001000010100000100000010000000000010000100100010000101010000000010000100001
00101111010010000000010000011000001001100101010001000000010100100101100010011001100001100000000010100
01101000011000001000100100010010000010100101100000100010100000000010000011000000000111011101010000110
00100000101111000100000110001000001000100001001010000000010111000100100001010010011010001010000000000
11001100001000001001000001000000110000001100111100101000001110000111000010000001111000000000010010100
10000000010100010011011101101100111000000000101100010000111110100101001000100110111001001000010010000
11011010010001111011000100011000111001100000001101000010001000110100000100000110000001001000010111000
11100000010100101001001000110000110011000000100000100010000000000000001001101000010010001001111000001
11111001111000000111011111100100111111111000001100001110000111100010010000101010000000101100010011111
11111100001101010001100000100001011111111111111000001000001010001011101110000100010101001110011011111
11111001000101011000000000101100001111111111111100100111011000110000000101011100100000100011010000111
11111000001000000001000010101101010111111111111000000101000001001000010000100000000000001000001000101
11111100100100000101000000000000110011111111111000000000010000000010111100000101101100011110101000000
11111101000010110010000101011000001000111111110010011000100001001100000100000011110000101000001100010
11111000010111110000100001000010000000011111111000000000001100100010001000000011110000000000000001000
