00011001001111100010110011111100000100000010001000010101000000000100000000000000000010010100011010000
00010000001101110100100010111101011000000010010010000000001000001000000111010001101001000000100010100
00000101000100000100001000010000000110011000111000000101101100011100000000010101100000100000100000000
00000110010000110000000101100001100001000000110001010001000010000110010000111100001001010010000000001
10100010000110110100100101110000001010010000000000000100100010001001101001000010000010000110001110000
11001100010001000000101011100111000000000000011010010100100001000000000000101101110000000000111110100
10011110100000000010100011011000000000000001010110001010000100000100100000001000010000100000011100010
01011110000000000010000000001110100000101001000001111000000100000001001101101010010010001100001110010
00011111101000011000010001101111000100010001001001011011011010011011011010001000000100001000000110001
00010111001010010000100110001111000011011001000101001000100001000000100000111101001010101101000001100
11000000001010000111000100110010001111100000000000001100101001010000001000100001001011110100001010001
11100000000101100001111101000000000110001110001010011000101001001000000010000000000000100000100110101
01001000001000000000110011001010100010100010110000000011000000010000110010100000001100011110010010100
01001000001000000010000011000011100000010111110010100010010000111001111000000110111100100001010110000
01101000001000100000010001110000100100000000000110101110011000111010001001100110100100101100000000000
00011000100000000001001100010110101111010001001111100011011000010110011001000001000000001000000100000
00010100001000001101101111000000001000001001010111110000011010100000110000000001100111101000010010001
00000010010000000100100101011010000000001110010000101100000100010110010001001001010010000010100100100
01010000110001010000101000100000010000010001000000000100100001001100011000100100001010010100001000110
10010011000010000101000000001000000000100101001101000000100001001000101000011010000011110010101010000
00111011010000100101100100000101000100101101111000000000000000101000000000000000010010001000110001110
11111100000010100000011001110000100001000000000000000011011000110000000011000000000010010110110100100
01111110001100000100000100001100000000111000000010011011000000100000000001000100000000000010000000000
00111100010000000001010000000010001010000000000001100001011000001100000000000011010000000011000111000
00001000010011001111100100100010111110000100001011111101111100001001000010000010010000100010100001000
01000010011111000111000000001000001111111000100111111010001110010001000110100100110000111000000101100
00100100000000010110001000010000000111010000000011110001010000010100001110010010111100100000000000011
01110000000000011000000010001011011000000010000001010000000100000100000110100010010010011101011100001
01100001001000011010101110001110001000000000000100000100000000101101001000010010010000100100000011000
00110111111100011000110010100000010001100010001101111011000100000101000000101001010010110000100111011
10010000010100100011000001000011100000001010010000001011011000001010011101000000110001010000110000100
00000010110000000000000000011010010001011100000110000000001110000000100101010011000000010000110000001
00100100000110010000010000100011010100001000011100100000000111001101000100001010010100110010000100001
10100000000001000001111100010000000010101000001100000001101010001110010000010000000101001111010101000
00010000000000000011010010000000010000000011001000010000010010110101100000000000011010100010000001001
00111011100000001000000110000000000101001011010011110101100010000000111100111010010000000011001100010
00010001110001010000110000011001010110000000010100000010000010110100110000001100100010000000000101100
01100001110000001000011010111100111110001000000101000111001001000010011000111111100011011001000010000
00000000000000011101000001000001111100010000110001100010000010110000101100100100000111111000010000100
11010100110010110010100001000010111100010001000000000010100000100001000000010010000011101110111111100
00000001010111100010011000001100001010000000000101010010001010001001111000100110000000101011111011010
10000100001111100010111010000001000000110100111110001010000000000011111000101101000100101000010001010
11001000010100101000000110110001001000101001111000000110001110000011110010100100001111100001001000010
11110000010001110000000110101100000010000010100000000111000010000111111001000100100100000101001000100
10000001001001101100010001001100101000000000000000001010000000001111111000100010000011111101000010011
00111101100000000000000010001000001000110100111000000001010010011111111110010110001011100001000000000
10011010000100011000100111101001000000100001010000001110111101101111111000000000100000001001100001111
00001000000001110101101110000111000101110010001010000010001000100111111010001100100111000100111111111
00010011000000000100101100010010010010100100011000011101100101100011111010101110100000101000111111111
00010100010000100000000000010010011000000000000011011001010001010000110000000001111100100010111111111
01000000000000000000000110111010010100100100001000010000001100001000100111001000000000011100011111011
10000000101111010101100010011110000000010000000000000011100001100010000000001101000000000110111110000
01100010000000000010010100001011001000100101010100110000010000101000100010000000100100000001111110111
00001010000100000001000000000000010000001100100000110000010000001001110001111001000111000000111110010
01100111101001000010100000000000001110100000101101000000100111001000100011111000010001010010111100000
01001000100000100000101010100010110001110010100100010000101111101101101001111000101001010001110000110
00010001000111000000101000001001000010000010001000000000000010101000000001100101000010001011011010110
10111000010010000010010100001000101000111010100101011010010000000000100000100000000101000000000010000
00111010000100010101100010000001000100100000100010100000001000000000010100100001100100000110000010010
10001001000000010001011000100001001000000000100010000000001000111011001000000000001110100100001111010
11100011100011100100011000100010100010001000011100001000110000010100100011101110111101000000000111011
10000000000000000000000000000000100000100010100000000000011101000110010000000110011000000111000010010
00101010011111011110010000000010010000100000010000010000011000000000000100001001010001010111000000010
00000000010000111110010100010011001000101001110000110001000001010110111000000010000000011111110010000
00001000100100111100110011000000000100100000111000100101000101010100000011000000000101000110000000000
00110000111000011100110100101001010011000100101000010000101000000001000010100000100100001110000010000
01000100100000000001011101101101100010010100000100010100011011100000001000011100001000100101011000110
00001110100011100000010000001000000001010111100001010110000111010001010011011001100000001000001000111
00000100000000001000110001000011001000010011011011100000010011000000000000001001000001100000001011111
10001000100010010010011100000000000110001111001100000000100000000000010000100111100000000110000010111
10111000001001110111101010000001010100000010001000000101000000101001001100000001011000000001001010111
10000100000011100010100000011001001100100010000100111001010100101101100000100101010011000010000000011
00100000000011001000000100000001000100100000000000001000010111110000010100000000000011000010000000000
00000100110001000101100101110001100111110011000001100100100010010100000000010000000100101010100101010
11110010001100010000001000100001010010010000000100001000100100010000000101100010100100000010101011100
10000111100000101010111100001010000000101010000000000010110000100010000100000000000000100000010001000
00000111100101001010001011001000010100000010000000000110000000010110000000000100000000000001010001010
00011111101000000001000011001001111001000100010000010111001101011000000000000001000110110100001100001
11010111111100011000001011000100010000000010100000010000110101000110001010101000001001010000001000100
00000011111100000010111000101101000000010100100000100010000101101110000011000000100100011110000000010
00111000000001000000000101000110010000010000000000010011000000000100000100110000000101100001101001001
01000100000000001001101100001000001001111100010100001000010101000100000000010101000100010001001110000
10000000010110110000001001000000000000111000010100001010000000000001010010111000001000000000100110001
10110010010001000001010000100100000010010000000000001000001100000000110000111111010000110010110111000
11000110110011100011000000001000110110100110100100000000000100100000111001000000100011000100000111011
11000111000100010000010001100000010010011001101000011110001011110000010001000010000011000010010111000
00000111001000000001011100100001011100010100101000011110000001000000000010010100010010001001111101011
10000000111100000101011010000011000001000000101001011111100010001000000000000101010111101110111000000
11100000100000000001000001101011000000000100010010001111110100010000100000001100000001111100110100100
11110010010010100010000100001110000011000010100001011001100001000101001001100000000100000100000011000
11110100110000000011000101101001001001001000010011010000001000101101011101001000110000000001101010000
11100110100000101000101010010001000101000100001000010000010011010011001111001001011100010100101010001
11100100001000101000100000100001000010000001001110010001001000000011000001100010000000001110001000101
01111001001100111000000010001000110100000000001000000010000001000010100000000000101001110000000001111
01000101110100010000000000100010001000000000100111010010000011111000000101110110101100000010000001000
00011100000000010100110010000011011001100000000010010000010101101000010010000000101100110100101100000
00000000000111001000000110000000010000010000001000000011110001101001000110100000001010000000100001110
00100100000001010110000001110001001000001001000001000001000000000000001100010000000001010100011001100
00000000010100010000011111001000100100100000010001011010010000000000100101000000110001010001111001110
00001011011000000000000100011110000110010000100001100000001001000100000001011111000000111100000001100
00001011001101011110000000111110000010000101100000100100000001000000001000111110010000110000110000001
