11110000000010100000011111000010010011001100010000010000000100110010000001100000001100111100111100010
10001010101100010000001111000011000000100000000101100000010010000000001100100000100000111000000001100
00000000010000110011000000100000011000010001100101101010110111000010010101010100000100000111110111100
00000000000100001111100001010010001010011010001010100011111111000111000000011000000000101110000101000
10100000010100001000010010000001100000010000100000010111111110000000000100011110000000000000000000000
00000000001010010101010101110100011011010000101111010101111100000010000000000000101000000100000001001
10010101001000000001100100100110110100001100000000000000000001100000100011100101001101101100000010000
00110001000001000000000000010000100100111001001001001000000100000000010100011101100000010101011000101
11111100001000011001000101101000000000000000010011111100000000000000101100000000101000000000100001000
11101001000000011111110100000000100000000100000000011100000101100010001000000100100000010000000101011
10001000100010000011110110100000010000000110100001000111000100100000001010100001000010000010110100011
00001000001000111001001000010100100100001011100100101001000111000110110001010000010110100000000001000
00000011101000110100000110000000011000001010000000110100000000010000001001001001001000010011010011100
10000001000110110000001000101011000011110000010000000000001110100011001001011000000000111001100101000
10011101000000000000001011000010110010000000100110000000011000110011100000000011001010011011000001100
00100010110000011001101000110000010001000100001111000000101100000011001100000010000000011100000000001
10000000001000010001101100000100001101001010110111000010101000100001000101101001000011000111000001100
00100000011010010010001001001010001100110000000010100000100011010101101000010011000010111100001111000
10000000111001001000000000000011011100000100000100110101100000000010010000010110010000100000100101000
00000110111000010010100001001001000001100001000001111110011110100000001001000001001000010011111000010
01011111000000001000010011100000011011101010000110010111000010011000000001000000100101100001000011010
10000110000011001000000000000000000001000110100100010011000100000100010011100100000100100100111001000
00010011100111000100001000000100100001001111110010000000000010000100100111001000111001001000100000000
10100001001001000010100001100000110010001000010110100011010001000001000010100000101001000100100000010
11001000000101000010101001000010010000000100000011100110011011010110000100000110100000110001001000111
11010000100100100011000100111100001110101000001110010111000011100001000101000000000000100010000001010
01011000010001000010100000100001011000000000000000000111101011110100101011100000010001001100010000000
00100010000000010010000001011000001001001100001000000100000100100010000000100110000100000101001001000
00001001001100000101000000001100011101000010101100011010000000001000011001000000001100111000001000000
10000000000000010000000100100100000000010001100100000010000010011000110000000011001001001101010000011
00011100000110000000101000100001100100000001100111001000101001001000000000000010110000000100001010111
01000011010010010001001010100000000000010000000011000101010000010000000000110100000010101000101101011
11100001001001000111010000111001000000010000010000010001000000010010111001000000101011100000010001000
01001101000000100100010001111011100010110111011010001001100100000001111101111100000101010000110000001
00000010001011110010000100111111000000000000011011110000000011000100000100001000000000010000010000000
10000000000100011010000000010011010000100100000110000001110000010101000110111000000011000000000010001
00001000000000011100010000000001101000000000000000001000000010010010000010010110010010001100100010110
00000000010000111011000001011100000000000100000000001100110001000000110000000000010000100001000000000
11010000001000100000010100000000000010010100100110000000100100100010000110000010000101000000000000011
01001000101101111000000011001000000001000100111000100101001010101001010000000111101001100101000000001
00000010011100000101101100011000010100000101100000110010010000000000000000001011100110001100010110100
01000001001010010110000101010100100110101100100100111101000010000000000001001001000101010011000111110
01000000000000010000101000100000001100100110000000110000000010001100001000010001000001001011100111110
01100010001101100011110000000100010010000001010100000101111000010100000100100101000000010000010011110
00000010000000100100111110100100000001001010001010000011000001000000100000100000100010000010110011100
00000000010001111110010100100000000000010000101000100001010000101010010101111000000000011001110111101
11000110111101100010100100000010010100100010011000100001000001111100000000100010001101000000010001000
01000000010101010100010110000011001110001100111110010010001100000010011000100000001000000011001000001
00110000100001000001000000000011001000011110101100100101101110000011101010010010000000000010001000011
01001000101010110001000100000111000100001001100010000000000100011000000100000100101000010001001001000
00100010001010000111000000001010000001010001100101000010010011010001000100001001111001000100010000000
10010000010001100010010001100001110011000000101100010000111100010000001101011001000000000001000110000
01001000001011001110111000011000000001000011000011110000001100000000011110011001000000100011100010001
00000101000000111010010001010001001001101000001000001000100001001000111110010100000100011010000010011
01000011000100000001010001000011011000001000000011011100001000110101111100000000011010101010000100000
00001100010000100010010010010100000110010001000000001000101011010010010010110001110011000110001000001
10000100100000011111000000000000010100000100101000000110000100000000000000100010010000110001000000101
00010000000010000110010000001100000001110000100100000000110000000100011000010100000100110101110010110
01011000000000000101001000011100100000000001100101000000001001110100111100000001000010000000100001010
00110010010001100000010111001000000000000010011110000101101011000010011100001001000000010000001100000
11100000100000011100000111110100000001000000000110010011000000000000000011100001100010010000100010000
11110000110001000101010101110100000100000110000010010001011000010010010110000000000010011000010011000
11111001000101010000100000000000000000100001000110011100101010001010000000100011010000111100100000001
11111000100000000100001110110100000101110010000011100100000110000100000100000001001001111100000001101
10010000000100110110011110010100100000100000001010100110001000101000001100100000001010111101010110000
10000000000011001111011111001000111001100000110000001000101001110110011000000000010010101010000000000
10001010000010000010000001000000001110001001101001110000000000000110010000000011010010000001010000100
10001000100000000000000010000001110000011010100010000100000000100010100000000010101001001000101010100
10111000110010000010000000110000010000000000111000000010111100011000101001100010000001010011001000000
11010100010110101000000001000100100000011000000001000001111100000100000010010010100011101010000000110
00000111001000010000001010101000010001100010000000111011111100100100000000000100000011000011010000000
00001111100001000111000010001001010001011010000101001010011011101001110000100101000000001000001000100
01001010010000100001010000011100010000000010000011100110000000000001000000100000000000111100010110000
11100000000000100010000010010000110000001001000001000100000000000111110001100010100000001100100000010
00000010000000100000000000001010000110001000000010001110010000010011010001000100001000001000101000000
01000001001001010011100110000010110000110100011100100011101001100000011011100010000011000000100010100
01100010011111000010001111000001100000000000000000110000100100000000001001000001010111000010011101110
00000101011111100100000011001110000001000100100010010001100100000010101000100010001000011000100000111
01000000011111110110001100000000100010000111001010001011100111000001010000000011000000010000000000111
01000000010111000000000000000100000001000010011001000000100000010100000000010110000001000011001000011
00000001000010001000011011000111000100000100000100001000000010011000010001111100011000010010001111000
10001010110110011100011000001100101000100000100111000010100101000000100001000100000001110010000001001
10010000111111001001000000010000001001110000011001100111000001001001001000000000100001111000000010000
10000000011110010001100001011001010000110000001101001110110010011100000001011001001011111001000111100
00010001001111100010010000001111000000000100101100000100001000011111000000010101100001110001000111111
01000010011100000000111010001111001110000100000000001000111001100110100000100000001000101000010000010
00011010111110010100110000000111000000001000100110000000111000100010101000010010010000000001000000000
00101000111101111101000010000000000110000001001000111000000101110000000000100000100000000000000100100
00000100011101111111011001100000000010000101000110010111010100111101000000001011000011111000100000000
00100000011001111001011111000000000001000100010000000100110000010100100001000000101001010010011000000
00000000111010011011011000000100100000101000111000100000000100100000000100001010000010000010011000000
10000110010011000010010001001101000000010100010010010010100100110011001110101000101001010000000011110
00110100100011100000001010111110101010010000111011000011000000000000000001000010101000000011010000000
01000001110001010000000000111100001100000101111000000001001001001001000010000001101000000100100110010
00001010000100000001010001000000000000101101111101100010010100000011000010100001001001111100101100000
00010100101110000011111100001011111010010001010001110101000101011000111000000101000100010000010100100
01100101011001000111111100010010010010100000000001100100110000010000100011000100000100010000000011111
01100110000000001111111110001000110000111000010110000000101000011000111100001001100000000000100001111
10000100101000000111111110000011000100110010100000000000001100001100000000000100000000000100011000111
11000000100011111111111110000100000011000110111000000100111111011100100100011011000111100101111100111
11110010100111111111111110000010010100000001111111010000111100001000000111000010000111001111111001111
