11101000000000100001010010010011101000110000001000010001100010010000100001110000000000011010000111111
11100011011100001011000100000001000000100000011101001001001100000010001001010010000001101000000001111
01000000011100100111100000010111110000000000011110001001000000110000011101000100001110100101000101111
00011111001000110001001000010100000000000011001101100000010010101000100010000011001010000000001111100
00001000000000101000101000000000001000000111110000011001100101000010010000010000000010001100100100000
11010000100111000010000001000000010100100111000000000000000000010001000000000001100100100010001010010
00000000000000010000000101000101100100000111110001000110011100000010001110110000000000000001000000000
00000001010000000011110100000010010110010011000000110000000110100000000100000011001000110100000100101
00001010010011000000011101001010100000001001011001100001001100000011011000100100000100000100100001100
00001000000000111000010101011000110100000100011100010000010001000011010000011110100000100101000011000
01110000000001100010000001000011110000100111111000010100100001000000000010000000000010101100110001001
01001001110011000001000010010000000000101111111100101000101111101100001010111110000010011100100001010
00010000010111110101010000011001000000000111100000101000110000000100010100001001010001001100001000000
00100100001101000001110000000011100001110000001110000001001000010000110000000000001110000100000000010
11000000100000100000011101010000000000100000000000001010000010001110011000000011011110000010110000001
11000010100000000101011111111100101010010000100000101101110011111100000000000110011000101110000100011
11000110000010000010010100010010000110000011101000010000000010100000101000100001010000000000000010011
11010010000010001011010010010000000001001110000001001010000000001010100110000011000001000001100010011
00011001010001100000101010010001000000100001111001000000010100110000001001001000110001011100111000011
01011100001100001000000010000000100100000011001011100000111000000101001010110100000000000010010000111
10000000000011011101011001011100000001000011000000001000010111000101000000000000000100110000001101111
00010001000011001000001101100000000000110100000010001001010010001000110000000000101010000000000001101
01000000000000000000100000011100100110010000000100000010000000100000111100001010000000011001000010000
01011100000100000101110001011100001100010001110101100111001100000000001110100000001010010001011000100
00010001000000100000100101001111000000010010000010100000001000100100001000010100110001100000011010100
00011100000000010010001101100101101000001000000100010001010000000000010001000010100001001100000000010
01100010011000100100100001100100110100010100100111000001000010000000000100001000010011000100000000000
10011000000010000001100000101001110010000000000000011000101100010111001011100000001000100000010001000
00001100100001001100100100100001000111011010110010100001111110001000110000000100000000000100000000011
10001111100000001011001001100000010010001000111001000000110101110000000110001000100100100110000101001
10000001000000000010100000000001111111001100010001110000100001111111000000000101110000001110010111000
00010101000000100100000001010100100010000000001011100100011011111010000101000100101000101001001111010
11000000011001000010111000010001000000010100000011001100000011110010100000000101001001001001000010111
11001000000000000100101100000000001000010000101000001101101011100000010100101100000010010000001000111
11010000011000010100100000000000010010000000000001010010111111110110100000110001000000100010110100011
00111011010010000001100001000010011000001010111110111000000111111111001101000100001100000101000000001
01000101100000000101000001011000000000001000000000010000000011111111101010101000100000000100001001001
00001000101001000000000011110001001000100000010010101000010011111111000000111010000000010111110101000
10001011100100100100011000000110010110100000010000101100100100001100100010000100100110100100100000000
10000000000000001001001100001000110010111110000000101001110001111101011001010100001100100110000001001
00000100100000000101000101000001110010100001011101000001001000011100000001001001000001100010011110000
10000111001110000010100001100110100001001011001111010000011100011001110100101000000100001001000010000
10000110011110110010101000100000100100010000010001000000001101111101100110111000000011000000101001000
01001000001100000110001000000010100010110010000001110001001100111100000001011001100111100010000000100
00000101001000000100000011010000001001001011010000001010100011010010010000000011101110001000100001000
10101001001001010010001000101100000001011100111001100100101000000100111100001001001110000000001110011
11001000110000000110011110000010011101000010011101111010001000100100011110011100110100000001100100011
11010001110010001110101001000011111111101010111100100010001000100100111101000000100001110010111001010
11000001000101100110001000000001111111100100011110000000111000001001001001000010000010011010100010000
11011001000000011000001000000100011111001000011110010100000000001011001000100001010110001000000010000
11101011011100000000000101000100001110001000010001110011001010000000100000011010011110001000001001010
11100011111000000000001100000010000000010110000101000100000011101000101001111000001111100001110001011
11001011110010001010100110001010000001000000101001000000010100010010100011100001000110001000001101111
11100010000100010011000001011000101100100011100010010110001000000111010000101010011100110010001111111
11100010100000100010001000000000110000001000010000100011110000000010001110110010010000000000100111111
11001000001000001100000000000110000010100000000000010011100000100100000000000010000110001001000011111
00001010000011000000000100000110110000100110001100000011010011000010010100000000010001010000010001111
10000011001111010001011011000100011100101100011010011010000100001010010001000000000100010100001100111
00100000000011110001000000000000101000000000100010100010011000010000000100010000001100000111100111001
00100010100100100010000100000101000000000001001000000110100001001001010100000000000100001110001010001
10000011000000000001110010001101001010110011101010000101110001000000100001010001001000000101100011000
00000000100001100001110010000100110100000100001000000000100000000100110100000100000111101100011010110
10000000001010000000100001000100010000010000001000001100110010100000000000000100010011110000000000000
10000000000000000000000000000101000010000001000000010101011000010000110000000010010001101010101000000
11100101000101000101000000111100100010000000101111010100011100101000011010101111000000001110010010000
11110100100001110011100010011000010000000001100000100000011000100000000010000010000001101001000010000
11111110001010001000100000010010011000000111111001011000101101000000010000000100000000111100000001000
11111000100000000000010010000100110011101111000001001000000010010010011000100000000100111001100000001
11110100010001000000101011000000000110001111000001010010000010111000000001000110010110010000000000010
10000000000001111000001101100001101100010111011000001000000010010010000100000001010000010001000100010
10100000001011111110100000101101000100010111000100011011110010001010100100000010010011001010001000000
01000011010010011010001000100000110000000000111110000000010100101011011001110001010010101000100010100
00010111101000010010101111000010000100001101100110100000010000001000010010010100010110101010101001000
11010011000001000111010000001010000000000100110000010100000010111101011100100101000000110001110001000
11101001000101001000010000100100101010111010100101111000001000010000100000000000001010000100100000000
10000000110111010010001001001110000001010010111001111000001000000101100011101001001010000000001001001
11101001011000000011010000000100010001000000111000100111000101000100000011101001001000000100000001101
10001011000101110010000000000000000010100000000010000000010100000000000001000001011001000010100100101
00011000000001100000001001000000000000100000100111100100010100000000001000000100000001010100010100000
00011000101011000000000001000011010001000111000111101100001101010110000001101000011100001001010000110
11101010000000001101000000010010000101011010001011110000110000110110110100100001000000001000100100111
10101000000100110010101110110110001000000010000011110000000011111000100000001011101110000101010000010
00001001011110100010000011100000000100010001000110000000010000101110001000000111111111000000000000000
00001000011100100100000011110000000001010001010010000100100010000010001100001001100000001010000100001
10000000001001010000001000101001100001110010100100000001010100100000110000000011000011010010101110001
10001001010000000001100000000010000000100000001111101000000010100111111100000010000100001010011001001
11000000010000011000000111111100010010000001000110101100011100000000001000010110000100110010001011100
10000011001001001000100111001100100000100000010010000011011100000101000100001110001000010010000000000
00000010000010001100000001000000001000000100010100110010000100111010000000011110000100011010001011001
10010000011110000000010000000000100010000010011001000010000000111000000100010000110001000110100010011
01100011111010000010001000000000110010010001000001100010000011100000100100010000000111000000110000001
00001100111011101100010110001000000100010011100101101010101000100110000000001011000001000001010001000
10001100110001010010000001100000000110101001000011000100010000010010100110001001000000001001000000110
00010000001001000101001000000010001000000011000101000000100101011110000000000101000000000001010010101
00000100000000100001010000000010011010100111000101011000000000000101000100000001011010000000010111001
00000000000000100001100100010101000000100011101001000111100000000001100101001010010000011100100111001
11000000011000001000000001100000000001100101001000000000111001101100000010000001000110101010100100101
00010000011000001000000111010000010000000000010001000000001000000100001001000010000010000000101100100
11001110001000001000000000010000100000000101000100001000010100100000100101000010000101000011010000010
11000001101111001000100000000110111001100001100011000000100000110001000000000000011000101000000010000
10000000010000000000100101011111111100110010000111100100010100100000000001000001000000110011100000100
