10010000001111100000000100100001110000000000001100100000010011100000001100011111000001000011110000100
01000111111100000000000100110000000000110000010010000001010011001011101001011111100010011000001100000
01100001111110111000000000100001101001100000111001100000010011111001000000011011100100110001010000100
00000010110100000110000001000001000000010111100000000001001000010110101001000000001000011011110010000
01000000000001100010111011010010000000000100101000010000001001010000000000000110000000010101101010000
00100110110001000001001000110001001000101001100011100001001000010100101000010010101010000000000100010
10000010001010100010000100000100001011011100000100000101100100010011110100000100000110010011011100000
00000000001000100000100000000000001000011111001010000101100000100101110011000001110010100100001100000
01011000111110010000001000010001010010000000000000010101000000011100100100000100000010001000100000000
00000000110000000110110000010000010000011000011101001001101101010010110000101100000111000001000100101
00110000110110000011110100000100001000110000001000100111011110000000010000110110111110000011101000000
00010000000001000010100000000101110000000000000000010100001001000000001010000010000111111111110001110
00000011010001011000000110001000001000000010000000101100000001100010010000010100010110010111101011110
01110100010001110000000100000000100011100000000000001000001011110001100110000000100000000010100011111
01101000011000111000000000100100000001011000000010000000100001111000000011110000100100000000101001111
00000000000011010000011001011010011111010101010101001000011000111001100110010001100000001000000100111
00000010001001001000010011001000100000010001000000000001000000001000100000000000000000110000001000010
00101000000010000000000000100000010010100011000000010000001000101100000110111001000010000100000000000
11000001001000000000000000010000010000100001010100011110000001001000000001110000000001111010100100000
10001000000000100000010010000010011110111000001111011111110100000000111001110000000001110000100000100
00000010100000010000000000101000001100010101001111111111100000011101111000001100001111110001111100000
00011000101000000000000000001110110000000100001111111111000000000101001000100101001011100100100010110
01000110010000000111111000000001000101010100000001111010000001100010000010010001000000001110000000010
00010010010000100011010000000110010001000110111000010010001000111100001001100100000001001000001010111
01000100000100011010000100010000010011100100100000010100100000111110000110101100101000000011100001111
01000100000100100010010111000100100011000011000010100011000001011100000010011000000100001000101101111
00100100100000100000000001100100100010001000001001000000000010000100000000001000000000010000010000101
00001111001000010000010101111010100100000000100111100111000000000000001001001000011001000100001001000
01010000000010011001101000101001100000000000010011101011000101001010100000001110010011100001110001001
00100000000010000111000010100000000001100001010111000000101100000000010101000101001100000100101101101
00100000000000010000000001000001000010000000111010010000000110001011111111001001100000010001000000001
00010100110100010100000000010000011000100100011000001001000010000111110000101011010101000000010001100
01101011011000001001011000110001000010000010000100110010001000010011100000000001011100010000110000001
01101000000001000110001000100000010000101000010000000111001000110000000010101011000101000010000101010
01000000001001010010000010100000011000001000000010101011001011100100000100001000010001000000010000110
00101101001100001000110010001001111001000110000100000000100000101010110100011000100101000010000001100
00000101110000010010001000100100000000101001010001000101100000110000000010100010000000000000010100000
00111100000001101000001000110111110100000011000001010010000100011000110111111000000000000110111011100
01110000000000000100001001111101000010001010001100000000010100000001001111110101001000101111110000000
11111001000010110011010001101001110000011101101111101011010001100000011110100100000010011111100100100
11111100100100101001001100000000000010100000011111010001000000000010001110000001000010000011001000001
01111100101000001101010101011100000010001000111110000010111110111111010001011000000100111000000001000
00111000000110000000000100000111110000100001001000010100001010000000010000110001010101010000000110010
00010000000001011000100101001000111110010011000010000100110001001001010000010110000000000000010000000
01000100010100001110111000000101110001000000101110001000000000000110010001000000100101100000011010000
00100001011100001010010001100001111101000001000101100100010000000111010000111000000010000010000111010
00011000010001001000000000000000010000011001000001001101011110100010100010000010010100100000001000001
11001001000100100100000001011011011000101011100100000000000011110010000100000011000000001100001000001
10000000100000110010000001100011100000100111000001100101101000100000100000001000100011001011000100001
00000010100001110000010010010011001000101110001010001111000011010000101000001001110000000011000000000
00001001101011111101101000001000100000000100000000000010001011000000001001010111101000110011111101000
00010011111011000000000000010101001000000000010000001011101110001010011001110001000011010000000000000
10000001101000110000000000010101001001100110100010100000010010000100101110010000110100001000100100001
11010111101010010100001010000000001001000101000100010000000001000000001110111000010000011110000010011
11110001100000111111001000010110100010010000001000010100000110000001111100000101000000011000000001001
01110001000011001001100101001100100001001000010001101101000100110001111100000101000110000000000100110
00000001001001000100110000001110001011010000000100000110011100011001111100010111100000010100110011110
00110001010011100010001001000100000000000111100001010000000000000011111111000110001111010001000000010
01010111110100000011001000000000010000100011111100000101000000101001111100000000111110010110000000000
00000110011111111000000000000011100111010011000011101110010100000001011101101111111100011000010000000
00011010001010010001000110000000001011000000010001000100000000001000000010001001011111010000000010000
00000010110000000100011000000100011000000001000101000010000000000100010001000000000001001111010100100
00011010000100110011000010000001101110010000001100000100000000110000010000001000100100000101001001000
00000100110110110001010000101000101000010010000000000000010000000001010010001000100110000000001000100
01000010001000000010110110101001001010010100110100101000001010000001100100000000010110000110000011100
11000010100001010010000100100000000000010000100100001000001010000000001000000001100100001001100010000
11001000010010001000110101000110010000000101100010101110100001100111110100001000001001000000000011011
10001000100000000000000000100000010001000101000000001000100110010000000001011011010010000011001101001
00101101001000000010001000011101001000000000000000000001110100011110000100000100011010001000010000001
11000000101011001001110001111111100011000010100000010111101100000001000000101010011111000010111011000
10010011101010011001000011111111111010000010100001001011100111010000100000010011011010110010100000010
00001001000111000111110111111111110001101001100000010000000001011101000000000011000000100100100101000
00100010000101000011000000011110011001000001100010010000011100100000000000000001111101000000000011010
01101110000000001000000011011100010111000010001111000010011100000100001100001010001010111000100000000
00110000000000000111000110011000000000000100000100010100011000010001011100100010010000100111000011011
01000001011101111001011111000000011001000101000000000100001100001001001000010100011001100110101101001
01000000001000010101100000100000000000110000011011010000100001010000000000010100001000000000001100000
10000000000000100001010000100101001000010000100000001001100000011010001101100001100010000001000010111
00100000000110000110001000000001010010111111001000010000000000001001000000011101000010010000000100001
00100110011100100100001100001100000011111111111000000000001110100001010000110001000000000000101000000
10010011000100010010001100001000110001001111110001110001000110000111000100010111100000010110110010000
00000000000010000011001000000001100001011100100010000010000000100001000010000001001001010010011000010
00001110100111100010001000010011000100001000001001000001100000000000001000000101100000001010000010000
10000101000111000010000000000010000011010001011010100101010000000000000100100000011100000000100100000
10011001000011000000000010100100000001000100000010100000000000110000100000000100000001000110110000011
00010101000100001101100001110010010000011010001100000010110100010010111010100110000110111010000000000
10000000110000100000010010100000101111000000001000000100111011000000000111000000001100011000100111001
00100011010000001100000000000000000000010001010010000110110000010010000010001100000000100010100111001
01111001010101000010111010010000110111000100110000000010100011011011001000000100000000111101110100100
10000100000011000100100000000110000000101000001000000000010010001000110000111100100001001001110000000
00000010101000110000000100101000001011101001001001000011000010001010100000111001001110000001111000101
01001000110111110000010010110000001110001000111110011000100100000010100001100000000111100100111111100
10000000100000000000001000100001000000000100111001000000100100001000010010011010011111111100111000110
00010010000100000001000000110011110010000111011001000001100100110010000011001001011111111110110100000
01010000101000000010000000001000000011000010000100000010000000010110101100010001111100001000100001101
01010001100010001000001001101001100010000010010010101111011001011100011100011001011100000001010001001
10110001000101110010100000000000001000010001010010010000001100000000101000001110010001000000000100000
00000000000001000010100000101001000110000000001001001100000010000111000001111101000000000001000001001
10000111000001000000000000000100000001001000001100100000001000010011000101001000000001000110010001000
11100000000000110001001001010001000001010011000001001000011000000000000001000000010011100000010010010
11101101110000000011110000000000100000001011110000000100000000010011000111000100000000011110100010001
