00000000010001000001000000101000001001110011000110010001000001100011100000000000010001000000000000111
00001000001001000000010110001100000010110000000100011101010010000010000100101001000100000000000011111
00000000100000001111011000001001000100110010000010110000100100000000000101100001000000001101000100111
00010010100011010001110001000100000000000000100000110010001100100001000100001101101011001000001010001
00010010100110000000101100001010101100100110111011000000001110000000010001010100000001001010010011011
11000000000100000100000100101000000101000010000000000000000100001000010111110101000010000001000010001
10110000000000010001000110000000100000110001001000110101100010000001000011100000010111000010000000011
00100000000110101010000011001111111010000010100101000010000001000110000000111010000011000111001100001
00000100001110000010100000011110000001100010000010110000001011001001010010100000100010100011000110000
01000010000000001111000101111000010000000010001100011001011110010101001000000110100100010000011010000
00000000000010001110010001111110010001001000010000000000001000100100110000010011000010000101101000010
01010110101001100110001000110000010010100100100000100010001001100001000100000110000000000000000001000
00010000010100001111000000001110000010010011101011000001110101110101000000010000100010001100001000010
00001100100011001110100100010000001010110111111100001010100000010010100001000000000101011111000001101
10101000000010000100001000100101101000000011110000001000001111100000000000100000001100000100000111000
00000101001101100000101000110010000000101100000000100010100011001000111011001100101111000100011000110
01100100000000100010010000010000001010000001010010100011001000000000010001001111000110001111000010000
00000011011010100010000101000011000001001100111100010110000110001000011010010111100001000011010010100
00001001000110000001001011010100001000000010011110000000011100100001000001100011001101001001000110000
01001001101000011000010010100100100010000111001111000101000100001001100001010000000000000010010010011
10001000001101001001000000000000000100101111111100110001001111101110000100001001000100001000010001000
00000000001000100110000000001000000111110101001000011101000000010100011000100000110000000000000010010
00100101000010010010011110010000010010010000100101010001000100100000000000010011111000000000010000100
00000010001111010000111101000000010110000011001100100010000000000110000011000111110000000000000000100
01001001001000011001001101010000000000000100000000010100000100010110010001000011100101101011001010001
00001001000010011101100000000000111001100001011001001011100000000001001100000000100100010011000010100
01110000001100100000001000001001110000000000110011001000001000000100000000000010110000011000000100001
00100011001100111010101101000100111001100000001000001001010001000000000000001000001100000000011000000
10001001100001111100000100010010111100000000000110000000011100000000000100011000001010100000000010111
00000110100100111110011001100000111111110100000100010001010100010001100000111110000000011010000110000
00000010110000011001010000011000111100110000010011001010110000110000000100010010101001001100000001001
00011100000011000000100000110111000000001001000011000100010001111000000110000100000011011001010000000
00000100100000000101111101010001000000000000110000100000100001110010010001110110001110100100000000101
00000000110100010110000010000000101000000001000101110110000111110011001001011000100110001001100010011
10111110000000000100110000000001100010010000100001101000000000010000010000000000000111001000000010111
10001100110100000000010100001100000010000000100000101000010101011001000100000100010000001001000110011
00011000000001101100000010110011000001000100100010100011001000001000001000010010010010000010000110011
11000100000000000010000011000000000000000000000101000001010100100010010000000110100000000100100000011
00100000010001000111001110000111000001000000000001110010000000100000111000100010000111001000111000111
10000100001011001110000000000000000001000010100000110000001111001101111001000100001010000100010001111
11000100000000100110001000101100010100100000001000010100000010000000000000010000001000011000001010101
11100000010001110100001011100011001110111000010110000010000011000000010101010000000000000000100000000
11100100010000011110000000110000010000000000000000101010100010100000100001101000011000000100010110010
11001001110110100001100110010011000001000010101011100100010010010100000000001111001100100011001010000
11100100001000011000001000000110000000000100001110100000010101000010100111011000000010100100100001100
10010010000110001000110101000010100001011110000000011110010100101001000000110000000000101000000111000
10100001000000000100100000000001101100000100010000011010100110010010111000111110001000000001000000111
00010101010100000000001010000010110000010010000001110000001011010000110001010000101111000001111000000
00000000111010100010011011011000001001100111000000100001111000000100101001000011000010011000001000001
00011000110000011001010111110100100011010111110000000000010110100010000010010001000010000010100100010
10101000010110000000000011000101110100000011100100100011000010000000011000011101010000110001000000110
10000111001010000000001000000010100000010000100000100110011100010010001100000001000101100011000000000
00010000000000000010001101000000000110100000111100010100010000000011011100111100011011110000110100000
00010101010100110000110100001010010000000011010001111010101001111001101011000101000000100010010000101
00100101000000010010100000000000010000010000000001001010001101000010000000000000000110101000011100000
11001100100001000000001000100000101101000001001000010000100101011111001010000000000000000000000101000
10001001110110011001000100101000100010000000000000010110000000000111000100000000001100010001000010110
11001100000000000100100000011000000000000010010000100000001000010110000110010001101001110000000100100
00000110000011000010000110101100000000100010111000000100001000000001000000011001111001110100100000011
00000001000010100010010000000100000000100000000100010110101110111100000001000100110000001101110111000
00101010000000010000111010001000000000011110011111001000011110111110110000100111000000000000011010010
00001100001011000000001000010000101000100000111111100000001100111100010000000100000001001101100000011
00010101000100100010000000000010100000010010010100000110100000001000000101110011000001000100011011110
10100000001100101000001111001001001101000100000000000000000010000000000011111000110000100011000101000
00000111100000000000011010010001010001001000110011010110100100001000010011110010100001110111100001000
10101111100001000110100000000001100000000000101000000000010111010000000001100000101111101111000100011
11010110001000000001100000011110001000001100000100001010011110000000000100000010000100101111000000011
10000000001011000101000001010000111001100011010001011000100000111010100001100001001101000111010101000
10100001000010100000011110010010000000011001010100000100000010000010011011110000110000110001111001101
10000000000000010000111001000101100000011000110000000000100001000010110010010010000000000011110000000
00000101010101101000011010010000010001011100000011000001101001101000100000001000000111000111101110000
01000001000000100000000000100010010000110000010000000100000000100000011101000100000111010010001001000
00000000000011001000010110101000100101111000100001000010001000001101001100101111000010110000001100101
01010100000011100010010000001011000100100000010001000010101000010100001101000111000000110011100000001
10011001100001001000000101001010010111000010010110000110100000000100000111010110001111001000000010000
00000000100000001111001100111111100100000011111110100111000000000111010010001101010001001100011000100
10000011000000001001011011101111111000101001010100100110010000010000001000100001110001010100010010001
10010000001000000000101000100111111101101100000001000001000000001011011101001011100010000000001000000
11000110100001000000000000001111000001001000010000000000001010010011000001100011100001011000101110101
10101000001001001011101100011010000110000000100010111000001000000000000010000001100110010000000100000
00000000000000000010010000100000000111000000110000000110000001000001000001010000000100000010011110000
01010000001010000110000101010001011010010001000000010001000100111100000000011000000001011000011110001
00010000101000000100001110000010000010000001101101001011100100001000001110000110010010101000111110000
10010100100100011001110100111001100101000000011101001110010010111000011111001000100000000010111100111
10001001000111000000110010011110000000000000000000011100100001111000110000000000010010000001111110010
00001000001111110100010001001000000111000101000000001001111000110000001011100100000000101000001100000
10010101001111001010000010001000000001100000100101010000010000100001000000010000000000100110110001001
10100000000110000011010000010000110001110010110101001000000100100100001000000100000010001111001010001
00000000000000000000100100010000101101001010110000100001010110100000000010011100110000111110000001000
00100001010000001000101010010101000001000000001010100100001010011101001001000000000000001100100001000
00011101000000100000100001100000101101010001000000000110000000001000000001001000100000111000100110100
01001000100101010001000010100000011100001000001100000001000000010000000001111010100101001001101000000
11000000110001010100111000001100011100011000011100100011000000011000101101000000000010011101100000000
00010001111000000000001001011100000010000011000000011100000000010101010110011000001000001000010001001
00000010000000110010111000010000000000001000011001010101001100010000010000001010100000111000010000001
11000000111100010110000111001000000000100011011100110001011011010000100000001101001000100001111000000
00000101111110001111010000000000101001000100100000010110110000010100111110110000100000001100010010101
01100111111110110000000000000110000101100000110001100000001000010100000100000000011100000100011000001
00000011111110001001001001000111000000101000100011001100001010010001000101000011001010010000101010100
00010001111111001100011001011111000011001000000000000010001000000110010000000111000010000010000111101
00000111111111110000000000000111101000000001111000100000010000000100010010000010010010000000000010001
