00111000000001110000000000000001111101010010100010111000000010011110011001000100111111111110011011111
10011110100100110010000000011011111100000000100100010101001111001000000100100001011111111111000001111
00100011100100010000100000100000011000000000001001000001010001011100100010001000011111111111100001111
01010011100000000001010000101100000100000000000010000001000000011000100111100000000111111111111011111
00000011110000001000010111101001100010000000001000101000000000000010000000110001100110010011110000111
00010000011101000000010101010100101100000110101000000001100000101010110110011110000001000001111010011
00100001001101010101000000000001010001001000001000000000010001000001000100000010011000001001100001000
10000111000000000001000010001100000100001001100000000101011000000001110100000000000001100011110100101
00100000110001010010011011100010011101010101111010000100100001010001111001000101001010000001100000011
01101100110000000000000011110100001111000000011000000101001011100001100001001001000000011001111001011
00010000101010000000001111111100000011000110111100100100001001100010100000000010001000000001000000111
00001000000000001101000011111110001001010001010010010010001101110100010000110000000000000000110001011
01110100101110101111000111111111100011001000011010010010000100100010000101111000001001000010000001001
00010000011110011111001110000000101011010000000001000000101001000001001010000100001001000100010111000
01001000001100011110000100010000111110001111000011011010010000000000011010000000010100001110011000000
00100000000000000100000000110101001000001000010110001001111001000000011000000101010100010100100000001
10001100011000001110010000010101001000010000000000001000001101000000000000010001000000000000000110011
01000000100000100111010010100000100100100000001100000100000001011100101011100000011000010100011111011
00101000001100000110000000000000100001101000001000001011110011111000000100001000010100000010000110011
00000101110000011110100010000010010001111010100100000010001000000010001000000010000101010001000110010
00000000000101000000001000000000001000100010100011000110001101000000000000000010101000000101010010010
10000010010011100010001111000000101100000000110010000001010000101010000011100010000000000100010111010
00000100000101001100011000100011100000011001000001010010000001011010001001000000000100000001101111000
00010001011000001010011000110000001001000000000001000000000100000100011001010010110010111111000011000
11110100010000000011111010100100001000000100001110000011000000010010001101001010100100010111100111000
01111100000100010000001000000010011001001011000010001000000110011001001000000001011110100000010010000
00100101010010010010000100000001010000111000001010000101000001001000110000100001000001010100000000001
10100010000111110001010000000000100111111000000010000100001000100000000010000000010101001001111000110
10001110000110000001000001100100001111111111000110001000001110010001001100000001001000000010000000000
00101000101111000011000000000100000111100010001111010110011110000001010000000100100011101001000000010
10000000000010000000010111001100101110000100000100100100111100010000001000010011000000100000100100000
11011010111000010101100000100010001001000011001010000000110000100010010000000010000000000101010011000
00000000000100110000100000100010010000100011110000100101000001000101001000000100000100010010000000001
00001100001110111001000010000001000000000000100000001000001100100001001010010000011000000010000000010
10000100010100110100011000101001010110101101001001000101101100001000000110000000011000000100000011100
00110100000001000000000111101010000000000000010000000001100111011101100000010000010001000000010000110
11111001000010000000100000001111001100001000001000001100000111100010000101000001010100101011000010000
11111000000000000010010010100001010000000011001000000000000110000000000100001000000000001000001100100
11111101000000000111010100100010010000110000000001100101110000000100101100010010000110011100000011010
11111100110100000011101100001110010100100000001100101000000100000011000111000100100100000100000011000
11111110000000000001000001100010000010101000110011111110011100000110001111000010000001100100010001001
11111100010010000000110011001000000000000001000000100010010100000101001010000001000001100010001000000
11111100001100011000100000001000010010000010001001001000000010000000000000001010101101101000001000000
11111001000000010000000000000000000000001010110010001110000101011000100000111000000000010001000000000
11110000000100001000000001000100010010010010111011000110100000001101000000000001111001100100010000100
11110000001000001000001000100000111000001000010010111100000101001001000110000010011001100100001010011
00110101000000110010110010110000000101110000110000000100000000000001000010000000010000100000101010111
00000100110110000000000010000100000000001001110000000100100010011000001000100011000000111010000100111
11011111100000000011101000100000100111011011011010101101000010110000110001000000010001100111001111111
11100100101011010000100010001000000000010001000001000101000000010011001000000110000100000110110100110
11100001010111110110000000010110001101111101101001010000000110000011100100110100010000001000000000000
11000100000111100000001111000000000000111011101000000101001000100101100110010010001111101000010000000
11011000010000001100000010011101111000010000001011000100011111100000000000000010110010000000010000000
10010000000000000101000011000111100001110001100000001001001000110000101001000100100000010010000010100
00011000011000000101000101010001100000100001000000000000000110010000110010100100000100000000000001001
00000101011000000000001001000000100000100011010010100000100010000100110000000100100000000100000000000
01101000000111000100010000100001000110001000100000001100101100000011000001001101000000100000101101101
10001100011000100000010100010001000000110000100011000010010100011011010011100001101010111000011111011
10001000100000000100111000000000010110000011000001101000000000001100011010000101101000000000101110010
01000010010000001001110001101110110100001010000011000010011010001000001100001000000000011000000011000
00001000000000010100110010000001000000010000000000010000101010011000000011000001010010011100000100000
10110010000001000011010100101000111001101010101010000100101100001000000111110101000000111101000100110
11000000001011000010010000000111000010000000001001000001000100100000100011100000000001011101010010001
11111000010100000000010001011001100100100111010000000100000000010000000001100101000000001100000001010
01111011110000111000100100110000110101000000001000011100001001010011000000000000001100100100101100010
01010000010000000010001000111001101100000001001001100000000000010011000001000000001001000001000000000
01000001010000101110001011010000000000100100010011100110000001000101000000000001110000000001001000000
01001001001010000000100000000000000001110001000001100100000001010100000001000011010000111001001100100
01000001010011000011110110000000010100011001100100000000000001000001001010101001010001000110010000101
01000101011000011011100010000000001001110110001000000001110101101001000100100001001010110000000101010
01100001000000000111011010001010011010000000000001101001000111010001001110010000100110001010000110000
00000011000100100000000000011100110000100001000000000010000000010110100110001000010000011000100100001
00000000001100000000000101000100101000010010100000011101100000000000100001010100000010010000100011011
00110100000000000000000010011000000111010000000111010001010100110010000101000010011100001000100100001
00001000001000010000001010000010001111100110101111010000010011011110000000000010100011111000011010101
00010000101111000100000001011000100001000111111111111001110110000000010010000101101100001100100000000
01100101001101000001100011100011101100111111111111110000010010100100010010000000001000000001110100100
11010010000001000000001000000110111000001111111111100101001010100010000001100000000101010000100000000
10010000000100011100000000100000100101111111111111101011101101100100000110001010000011000110000001000
11000000000100000000100010000100100000001111111111001001111100000100100100010011001000001111000010000
11111001000000100000100100001000000000101111111111101000001000110100000100000101011100000100010001000
11111010010100010010101110101001111100000011110011000000100000100001001110100000001000000010001000100
11111110100100000000110000000001000001000111110101000010101110111000011110001100010000000101000001010
11111110100001011110010000000000000001010111110000011001000111000101111110000010000000010001010100000
11111000110011111110010001100100110000101001110100001001000111100000110101100010100100110100101000100
11110011111111111111010001001000010000001010000000000000010000000000000100000101101110000000000000111
11110100011111111111010101000110100001010000001010100001100000000001001101000001001100000010101100011
11110001111111111111111000001110001000110011111010000000110000000010000001100011000110000000101100010
11101001111111111111111100011100001011000100100001010010100000000001001010000000001000100011001000000
01100111110111111111111110101010000111000000100011001100101100000100010010111101001000000001101100010
01010011100111111111111001000011011110110011000000100010010010100000111011110010001110101100011000110
00000011000001111111111100010010001100000011000100100011000010010010010110100111011000100000101000010
01000000000011111111111100010110011101000011011100001010001101100110000000001001000110000100000110000
10011110100111111111111011001000100101000100011110010000000100001010010101100100000011000001000010000
11010001101110110111101000100001000001011001111111100010011001000001010101000010110101010110100110010
11100010000100010011100000001000100011100101111011100000011010101100000101000011000001010000000000000
11110010000100000011010010000000011001101111110001000101011000111000000000100110100000001000010000000
11110001000000001000000010000001000100100101110100000010000100000000011110000100001000000000001000011
11111100000010001100011010010011110001010000010000001000000000010111000000111100111100010100010010010
11111100000100100001100010010001010011000010100101001000111000000111100010010001111110000000000000000
11111100001110001001100000000000000000110000000001011100000000010011100100000011111110100001100000000
