11100000010000011111111000100111110011000000001001001011101100111010100100000000000000111111001000100
11111000110101111111110001000011110010010000000100100001100000000010000000010100001000111111011000101
00100000001000011111100100000001100101001000000001001001000011010100001000001010010010011110000001001
00000000011100011110011000000000010000000001010101011100001001000000001001111010100010111001011000001
10000000001001101000100100011100000000000001010010000111011000100001011000000001000000000000001000000
10100000010001000011100000001000100000010000111000101010001110010001001001000001001100000001010010001
00000000100111101101001000000000000001010100010000110000000100001000000100001110001010000000111100001
00010011000011000000010000010100100000010010001011000000100000001001100100010000000000000000100010101
00001100000000010100100000000000101000000010100000101110000101000000100000111000100000001001000111000
10001011000000000000000100010000010010010010100000111101010000010010110000111010000001011100000010000
00000010000000001110010011010010001100001100110001101100001000100111001000010000001000010110000100100
01000000001101000101000011000010001101011100011001100001100000100010001100000100000000000110000000100
00010000010000001001000100010000000001001100000000111100001100100000011111100100100010011010100101001
01010100011100001000100110011000001000011001100010111110100001101011011001000111000100010000000001100
01100100111100101000000010000100000000110010001101011100001001110100000010000110000010001000000000000
00000110011111000100110001001100111000000110001101001111000101010000000100110000100000011010000101010
01101110011110001100000101000001100110100001011100000100000100001100000000100000010000010010010111010
11100111001101000001111110100000010010010000101001000000100011011100111000011000000001100001010011000
11110011001100010001000100010101000010111100000100001110000000011100011000010100001101100000100100001
11100111100000010000000110000011100100110000100011101111100000001000011001000001111100100010010000000
11010000000000000100000001000111100000001001010000010110001000110000001100000011111100010000011000100
00000101100100010100100010011011000010000010000010000001000100001101010000100111111001000100011000000
00010100110000001000010100000000000101000100101000111110001001000000001000000011110000011010000100011
00100010001001101110010111110100000100000001000001001010010000001000110010001111111110011000001100111
01000000000000000100011100100110001001010100000000100000000110100000010100001110011000011100010101111
00000110111100101011100100000001101001000000001010000110101011000000100011001100110010111110000000101
00100010100010100001010010000001110000011010100000100010000000010010011000000110000011111100010000000
10110100011000100100001001001000110100101010100110101001110000010110100011000001010101001001000100000
00000101000000000100000100001001100000000000010100010000001100110011101000001000001100001011000000001
11001100010010001000000000001000000100000000110001000000000001001100010010010100000010100010001010100
00010000011011101000110101000010010010010010110000101000100000100100000000000001000000010001001001101
11000010011000011111100000111011000010000010000001001000110000000110010100100000100000000101100001100
00011010101100011100110001000011101110010010111000000101110100000100001100111001011000110000001101100
10100000001000011000101100000110100001000100000100010000101000000100000001000001000101001000001110001
00001100011011000000000101010000001000110011100100000001100000000010010001000010010000000100001111011
00000101100100010000000000001100000000000111101010001010010100100000010000001000001100101011100100000
10101000000000010100000110000010000000000111101000000000000011010010001000000000000001100000010010010
11000110000101010111010100001100000101000101101000001010001000010000110001000110000011010101000101000
10001111000101110100001110001110100100010100010000000101000100011000001010100100111001001110001000000
10001111100100001110100010000000010110000100100011111000110000111000101000011000001000011000100000000
10001111010011000000010000010000101010000001000000110000010001100110000000010010000100011100000000000
11010101000010010010000101000101100000000000010001000100011100000001110010000010100001100000000000010
00010000001000010000001010001000010010000000000100011000110000011001100001101111101000110000001000001
00101010111100010000101000000101100111000100010100010000000001100000010001000000100010110000101011011
00100001000100111011000101100000000000000100101111110010100100000000010100000000000110101000100000010
10100011101011110000000010000010001001011001100101110000110100100010100101000110011110001011000101000
11001011100000111001110101100010011010010100100000000001101000101000100000000010100110011001000110000
00100100010100100000001001110000101100110010101000100100000000000001010001001011001001010011000000000
00100000000011010101101010001111100010100001000000100010001000010100011100000001000000010000001001000
10001000000110010100000001101000001100001001101001010000000001110000010000011101010001001100001010011
00001100001001010100100110000000010000000100000001000011100101000010011100100101001101010001010100011
00100001100010000001010001000000010100000000001001000010010000000100000000000000001110000001000000101
10000000010001100001000000001101000000000000010011010110010000101110001000000001100101000001100100100
00101000010111100000010011000001011001000010110000100100000001000100100101001101100000001111001000001
11100101001111110000100000100000101000000000100011000000000001000101000001001001000001011110010000100
00010000000111110010001010010001000010100010100000111001000000001000000000000001100001001011000101110
01000110010111110001001001100101001000001100100000100010011100000000101000010000000000000000000011100
00001111010000010000000000001000000010001110000100100110000010010001001110000000001001010011000100000
01111111101001011001001000100010000001000001000000010000010000100001000010000010111000000011001001000
00111111001000010001000000100010001000000000010110000011100110000000011011100100100001000010010001000
01010101000001000011100000010001100000010110010110111111001110001010000000111100111010000100000100111
11000000100000000110000000100010000000010101001000010111010111100001001001010110000000010001001100001
11111000100001010010110101111100001000001000000001010101000111110100000000000001010000101001000010001
11111100010000000110110101111000111010001101010010000000110111111001101101000101000100001100000000000
11111101000110000000011001100010101010000000100100110100011010011100001100100010001000000010000000111
11111101000100000000011101010100001100010001001100000001100010001100001000000111011000001000010001000
11111111100000010101001100010000000000000010010000110011110101011000000010110010000110010000000010000
01111010100110000100000100100110110110000011010100000101000100010000101010000000110100001010101000001
01011000000000000100000100011000110000111101110100010000000100000010000000100101110010001010100001000
00000000101010100000010001001000000110011000000001001010000000000110100011000001001100101000011001110
00001010000000001000110111100001100000001110010000000110000000011100010010010000001100000010010000001
00101111010000000100011101001001101000001100011101000010000100110001001111000001010010000000100010100
00011110100100000001000000000000000101100010000000011110100001000001010110000000010111000101100000000
00000000100000110000101000001111011001011001010000000001010101000000000001000000010000100000100100110
01101010111100001000100000100000110000011000100000010001001000100011010010000001100110000001000010001
00001000000000011000100001001010010000000001100000100000000000010010001000100010001000111000000100000
10000010100010010100010001000100000100001001001001010001100000010001000000000001000010010110000110100
01000010001100010000011110000011000010001001100000011010110001000101000000100001100100000101000000010
00100001000111001011111100000100010001000100101000000010000001001110010001000000010111010100000001001
10010001111100000011000000011001001011011000001100101000110100000011001010000001100101001101000010000
01010010000000001111100100111000100000111000111111010000110000100000011100000000000000001000010100000
00000000100000000101100000111010111010000010001111000001000000001010001111000010000100101000110100000
00010001101000011001000000111111100110000011011111100010000000101000011100000011000001100000010111001
10100000000010100010101011111111100000011111000100100100010001111101001101001100101011000101010010011
01000001010111001010000011111111100000000111101100010000001011111000101000010110010001000001000000001
00000101001011000100010000011110000100001010000000010001000011110000110000000010001010100100010001010
01010111100010010001011010111110001010000001100000000101100000111101010100101010000010010110101100010
01000001000100010100000000100100010000110100011100100100101001111100011010001011110100000110000000100
10000100001101100000101101010000010000110100000001000011010010111001010000011000100010110100000000000
01101000101011000001000101001000000010000001101001001101000000010000000010101100000010110001101010001
00000001100001010010000001000100011000000111100001100100110000100000000111100001010001100101101100000
00100000101000000000000000000000010100001000010111000100010011100000100000001000011001000101000110000
00100000000000100000100101101011000000000000100001000000100010010011110010010011000101101100000000000
10011000010000000010010010100110000010110100101101101001000000100000111110100000100100000101000010011
00000000011000000010000000001000010110000100011000001010000100000101010000001000010010111101011100000
00100000000001110000000000000101000100100001010001000010000000000100000000010011000100010000001100000
10000000010110110010011000000110001110000110000001000000010000001000001100010000000000111001000000000
10101001000010111110000100000010001100010000011000000111001011000010011010010111000010011001001011000
00101001110110111111000001001000011100100000010001001000110111000000000010101100001010100100010000000
10100000000000011111011111000100011000100010000101000000000000000101000100000011001100000010001001000
00011000100001001110000100010000100000101000110100010101010100100000010000100011001000101001100000011
