00000101111101000010000000010000000110000111111000001111100001100001111011100010111000010000011100000
00010000111000100000010010100000111001000010001010000001000000000001110001010000000000100000000000111
01100010100101110000000100000000110100000010000100001010010001000011100000000000000011001100100010100
10001000000100110000011100000000000000000000000101001001010010101000001100000100000100100101010001010
11101000001001111011001110101100000101101110011100000100010110010010011000010010000100100001000000010
11100000010010111100111000000001001100010000010000101110000010011000001111000111000001101011000000000
00000010001000001000000100100000000010111000000100101111000000010001100001010010001001100000000011000
00000111000100101100110001100101010010011100101110100010000000110110000000001011011011000001100100000
00000010101001000100001000010000001100010001000110001001010010010010000000101001010000000000000000111
11110000111101100001000101100001000010000000000110000000000100000101000000000010000000100000000001111
11110000010001011001011000001001000000010000010111101110101001101000000001110000100001100101000000111
11100000100010010000001001100001001010011000010110000010100100000001000010010100000000000100010100011
11100000010000011000010000011000001000011000100000110100000011001000100110100000000000000000001000000
10000000000000000000100000010001111010000101001100000011010000101011001000001101001011000000101001100
00001010000100000000101000001010000001000110011100000000100010100000011101001010000000100010001101111
10000000001000110111110001110000101100001010111000000011110100000000000000010000010010011001100110111
01001000001001100111111100001010000000100011011101000001100000001000010001100100000101000100011110011
00000000100000110111110000010010100001100000001001000000101100110110111100010000000000010111000100000
00110000011001111111110100100100110001010111000101110001000101000001111110001000000000010001100000110
11001011000001111111100000000111111000000110001011000100010011010001111110000001000110000010000100100
00100110000011111111000100010100111001010010000001101001000011000011111110000000100100000000100101000
00100000000111110111000010111001000001000100101011000000001000001011111000100001000100011001110101000
00001000000011100000001010010000000000101010010011010000000010100000000110000010000111110001000100011
01010011000011110011001100110000000011000000100110001001001000001000010011110000001100000001000001000
00010100100111110111100010001000000100001011000111000010011110000100001000001100010000100011100101100
00000000000111110111110001010100001000100000001111100100101100010001011110000011010100100101110100000
01000010110111000000000000010010000000101000101100010011000110010110001000110000100010000000101001000
00011001001001010011000001000001110000101100100000010000000001110100001101000100010000000000100000000
11101010000011110101000001001011101001000010010001101001011000010100100001001110010101101001110000101
11000010000001000001011100010001100000001000110111000001001000000100001000000110000010000100000110000
11100010100000100000010100100000001011100001100000011010000001000000000100110001101100100001010011010
11110011010000011000100101000010000101110000010010111000011100000000000100001111101000001000001000000
11100000000000010001000010001000100000110001001000111101101000101001000001000001011100000000110000010
11101000000111001011100000000000111100110000101011111110100100100010000100100001001100001100010001000
11000000001010000011010010000000100001001010100011111110000000000100100000000010001000001000100001010
11010010101000000000001000000000001100100000000011111111100000000100001010100001011000011000000100000
00000001000111111001000100011100100000000000010110001001111000001011111111110101000111001001000100000
00001010101000000000110000011100101110000001010001100000100001000000000010110011000111000001000101010
00101100000100000000111010000100100011000000100101010010000000000100000000000000000000001010000010111
00001110000011001010001000001100110010010010000000010001011000100100000110101101110000000000010100001
00000001000010010000000101011010000000110001000000111001001000000000000011100101100100001001010010001
10100000001000000000011000000001001010001100011100011000100000100000011000000101000011000101000000000
00000100001101100000000010001001000110000001000010110001011000000000100001100001001000010110000001000
01010011001000010110100000011000000011000100010011011001000001010111000000000010000001000000001000100
00101001001001010100001010000101111100011000011001000000000011100000100100010110001000010010000000111
10001101001000001001100100000110010000001001010101000010010011011000010101100000010100011010001000000
10000011000001000011000110000000101001000100000010101000000001000111011100110110010000001011001001000
00011000011011000011100100000000101011100000010110000000010000010000111000001000010001001010000011101
11001010111001100000010000001001100010011100000000100011001000011000110000000100001100100000010011001
11010000011001000001100000010111100000010011000001000000000100000000001000100110000100110010000001000
00100000100101001000000111000001100000010001110010011000000000000100001100010100000000100000100000100
10001000001010000100000000011011000000010001110000111101010000000001100001100011001000010100100010111
11001010011000000101000111001000100000000010000100111000010100000100001000101010100000000010001010011
10011001000110010000100000100011100001010001000000100001001010011101000000101100011010010001100111111
00111100101000110000000001100000000010100010100000010111000000010000000001110000010000000010010100111
01010000010001111000100101010110100100100010010001100010100000000000100001111100111000000111000100011
11001001101101111010010000010100000000111000100101000010000000100011010110111000001100001010001000000
00100000000011111110101000001101011100000000010001000110100000010100011010001000010001001001100010001
00001010001111111100000100010000011111000010110000001000011100010000100000001010111101000100011010101
01101001010011111110001010111001111110110001111100110000000100001000101001000000000001010100111010100
01110111000000111111001011100011001100100101110000010010010000000101001000000010100101100000110000100
01110100000100011100101000000001000100010001101000000100101000100000001001000010000100001100000000001
00110010001000111100011000000001000100000001100000001000100000001101011101000110010000001001100000000
00011000000000111110111000000000110000010110000000100010001000001000011001010101000010001010011001000
01010000000000001010001000100010110010010000000010010000000001010100010000001000001110010011000011100
10001000010001010000000000010100010101010000010011000000100100010000110001000010011100101101101100000
10101000100000000000001000001001011001000000000100000010100000000001000001010000011110001000011001000
00100101001000010110000100010000000010000010110000000100000011000100001010000110100100001001000000000
00000010011110010010000001000001001001001010101110000111000100000000000000101001100010010001100100000
10001110000000111100100100100000010110000000001000001000100001000001010001110100100010010000100101010
00111110010010010010001010000010000001110000001100011000000000000101001000010110001100100001000010010
00111110010000111000000000001100001000000110101110100010000000000101000100000010010000000001000000010
00101100000000100001000000011101001000100100101110010000000001000000001100000000001011000100010000000
01000000001000000000001010000001111110011110001100111000100000100000000110000000010000001010001001000
01000010001000110001000000000001001010100000000100111000000010001001010000000101001000111000000011100
00010000000001001001101000000000000010100001010000110101000010000101100001001011100100010001011000001
01100010100000101101110000010100011100000100000000010011101000000001000000001011110101100100010100001
00101000001010000011100000011000000010001100000101000001000010010001001011100011111000010000000010001
01000110000001000000000001100000001010000110110100100000100111000010100000000000011101010001101101100
00000011010100110100101011110001000101000100110000010110000000011100010000101000100010000001101101001
01011110000000100011110101100000000100100010100000000011000010000101010000100000010111010000000000111
11111000011100000000000100000010100001000101000000100111100000111101100001111000000000001011001010110
01011100001001000110010000101001000000110100100000000111111000010000100000010000001000111011010000000
00011001000100000010000000100100000000000000000000001101110000100000000001100100011100000001001001101
10100000001100100110000100110100001000110000010100001001110000010011001110010101001111000001000011111
00101000101000000000110111100010000010000001001100101011110001000001001000000001000000000001010111111
00001000010001011011001100100100110100001000000000100000101000100000001100000000100100100010010001111
10001111111000000000000100010100000110001100010000001010001010000010001010001000100101110011000001111
00011001100011000011000010001110110100100100000110001110001000001010001000000001011110000001000000000
10010100010001110001010010000110010110000001000000000100010100000000001011000000001000010010000000001
00110000010000010101001000100000011000100001101000000000000011000000111100001100010000000100100010000
11100101101011100100100000001110000000000000001000101000010001110010000110111100011000000101000011000
11000001001110000010001011101110100001010000101010011001110010000000010110111100000001001001000000000
00010000000001100000110101000011000000000101100000010001000010100100111000010000000000000010000000001
00110010000010001100100101000000010110011001000100111000010000101110000001000111000000100001100010100
11100000101011010100000001000010001001011100100000011100110001110100010100111010011000000011110000010
01010100001010010000000000000000100011001000011010111001000010100110110100100010111000010101000001000
01000011010000110010001000001010001001000000100011111000010000000000100100100011110001001000001110010
00010000001000010001100101001001000000011000000000111100000011101010000000001000111101110001100011000
11000011001000111000000110001010101011100010000011111111000100001000100001000001111000110001001000101
11100000110000010010010000100010001001000000001111111111001100000100000001000000001001110110001000000
