10001111110000100010111111000000001010001111111111111100000100000001000101110000000000000100110011111
00011111110101000010000110000000000001100111111110001001001110011000010000100100000000100000100101011
00111110011001100000000000000011000010000011111111001101001110000010000000001000010000010100010000001
01000100010011000100001000101111000010000100111110011100011111100000010000100100000010000111110100001
00000001010000001001000000010000011010100000001111000001000010000010000000100000101011100000110100011
10001111111000100100011100000001010010010110011111000000011000000010000100001011001001000000000010000
01000001010000110000001000100000100011000100111100010000011001001000000000000010100110010001010001000
00000100000000000000101110100100111111011110111000100001010000000001000100100000001110001100100101000
11110000100110100111101110100001000111100000011100010000000011010000110011100001010110100000101011001
00011011110001010001010100001001010111110100000011100100100010000011000001100000100100001000001000000
00001100011100000000000010001010010011000001010100000010001000001000000000010010000111101010000000101
00000111000001100000100100010000100110000011010111001010000101101100000111000010000111101001000000000
00001001011000000010000010110101100000000000010100100000000010010000010000100101100111001101101001100
00100010000000000110100000000000010010001000100010001011000101010101000000010001100000000000000000001
10110001000011010100010010001001110000010100100001110000000000011000010010101000011010001000100001000
00000011110011111111011001000000100000100010101000100110000111000000001111000001011000000001111100010
01000011100001011111101111100010010100010000000000000001110001110000011110000011110000000100100000011
11100001110101001111101000100111000100001001001001001010011100010001000110100110000000000100010010010
01000101100001011111101000000010001000111010000000000011001000101111100100100000000000001010010000000
00110100010011010111000111000000010000000100111111000010001010000000010100011101101010100000011110110
00010100110110010100001000001011100000011111001010000001001000001000000001000000000111110010000100010
00010011111111000000000000000000000001000111000000110000100000100000000000010110011011000010010000001
00000011111110001001000001101010100000000011000010100011001001001100010000100011111000100001101110000
01010001111111000110001100001000000001000011001010000001010010001001011001001001110100001010101000000
11100100111111110101100100000000001001000000000000010110000100000101000101011000000110100010000110000
11100001011110000100000000010000001011100100000100101000110001000010000010000000001000110001100000100
11000000011000010000000101000000000111000000000000100101100011110000100100000110110001110000101010000
11100100000110000000100001100000000010000100000000101001000101110000100001000110110101101010011100000
11110000000000110000000000000001100000010000101010000000000000100000000001100000011000000000111100001
11110000100001001011001000010100011001010001001000001000110010000000001100100101100000101010011001101
11111101000011000000000000010001111110100010011011101110001001000000000000010100001000000000101100010
11100000000000100101001111110101111000010011011010011000100011010001110001001110101010101010000010110
11100001000000000100011010001011100101100001000000011110001100000000000100001010110000000100010010000
11000000000000100011000000100001000001000001110010011111011001100000110011001000000100000001011111000
00011100001100001001000101000011100000001010010000001010000100011111011100010000000100100100000100100
10000010000001000000110011100001110000000000001000000010000000100100001100010111000101000010010000100
11010111110100010000100010101011110101000001010110101011000010000000001001001010000001001000000110011
11111000000000000100100010101000100000011010000000001011000110110010001000011011011010100110000000000
11111100100000001000100000001110110001011100000101010100100110010100110010000001100000110011011011100
11111110001001000100001110010001100010101110001000110010001000000100100001100001000000000010001001001
11111110100000111100001001001000000110100010001001000000010000100001100001000000100101100000000011101
11111111111010010000000101000010010110000111000000000000110001000001100001100111000000100100100110001
11111111110111000110100000110000001000010110001100010110010100011000001000110011010001100000001100100
11111111110110010000101100000000000100000110100111100000010000000010100011000111100001000010000110100
11111111110010100000100000101000001000010000001111000111110100100000001100100010010000000011000001111
11111111010100000111011000101000000100011010000001100001000010001000111010011100010110011000001001111
11100010000100011011001001000000001101111000001101100000010010100000001001000000001110100001101011111
11001001000011011001000001001101000100110001100100011101000010000001000100000010001100110000011011111
00001011000010011100000100000000010010111110000000000010000011111000000110100110001000100000000111111
00001000100110000011000111100011000000110100010000000000000000100010001000000001000011111110011011111
10010000001000001100011100010011111101000110011100111100000000110000010000000000100001101000101001111
00000010010101000100100000111011100000011000110110010000000010001000111001100000011100000100100101101
10101110100000000010001000111011111000101100000001110000100001110000010001100000010100000000100000001
00000000001011100000000010010101110000001100110000000001101110000000001101110100000000010010010001000
11000000100110010011101010010000100000000001000000000000000000000000100000110000001100010000010000001
00000000110100001111000001011100000010010001000000010010011101010101000000111000001111011000100010001
00100111000000000110000011011101101010000110001001001100001000000000000000010010110001001100100110001
01100000001000100001110000111001110000110000011001011000000001001000000000010000100001110000000000111
00001000011001000001101000100001110100000011100001110000001100110000000010000000010100000000000001111
00000000100011010111100001000110000100100100000101000000000101101111000001010001000110010000001011111
00001001000000001111110000100010010000000100011111010100011100000010001100000011011000000100011100011
00100001000000011111110001110001100000010001001010001000111010101100000010001000100000010101000100001
00000001000000011111111001110000101100111110000010101000111010000000001000000101000011111111011001000
00010000101011001011111011100000100100110001011001100001111000001000000010001000000000000111000001000
00001000010010010011001100001000011110100100010000000000111101011010001111010100000000010111101000010
11010101100010100000000010000001001101101000000010011000010101000000010000000000100000100001111000000
00010111010000101000010111001100000000011100000100111010110000100100010000011101100011010001011100100
00000010000011111100001111101000101000101110000001100010010000011000000001010011110100010101001000000
10100000001111111010110111000010100111000000010011000001100000010100011001100111100010100010000000000
01000001101100100000000010010000000001001001010100101000010011000101001100001111111000000110000001000
00101110010010000100011000010011001000100101010001100100001111000000001110111100000100000010000000010
10000000011000010010001011001000000010001001101011110110101010000011001101111010000000111110000001111
00001100100100000111101100111110100000010001101100100101000011000000100001110010000000001010000100010
00011001000000001100000001011000010001100101101100000000100111110000101100000100100010000011001101010
00010111011010000000000000010001000100000000000001000010011111110011010010001000010100000000001001000
00010100001111111010001100010100000001000000011000000000010011111010000000001010100000101010000000111
00100110000000001000111110001000001011010010000000001000101010010100000000000100000000000100001001111
01110010011000000110011111001101110101100000011000000000000010000101010100100000000011100100000011111
11100000111110000000111111010001100100011111010001010010111100000100001011110000100111110000000001111
01100000000010011101111111001010000110000010110101000010000100011000010000100100100000100001000001111
00001000000100010100011100000000100110000000100100000001000000001001000000001100100000010001000000011
00000000000011000000101001100000100000101100000001011000001001100000100001010001110110000100000110011
00100011001011010100000110001000101001000000010000010000001000001001001000010100010000100100010010001
00101001101101100010010000000001011100000100000010001001101000011010000000100100000010000001000000011
10010000010000100001010100111000000101110000010000000010000000010000011001000101000010010100010100001
00011011000001100100001000000101000000010001000000000010111001001000000001000010011000010011010000101
00111000000101110100000010100100110000000111010000000000110010011000010010001010001000011000010000000
11110000010100001000000001001000100011100010011100000000000100010000001100010011001011100001111000000
00111010010100111110011000011111001110001010010000101010100011100001010000000001100100010010100000000
00000110010100001111000010001110011100001011100000000000010110100000000000001001011100011110100000000
00000000010100011111100000100110111110100100010011010000001110101000100100100000000001000110110000100
00100101100000111100000100000001101001111101100011110000000110011000000000110101000001001100000000000
01101001101001000110101001001001000010000100000011100101100000000011010011000011010000000100001100011
00111010111000001101100000001010000101000000000101100111011010100000011000000000010000001001111110000
00111010100001001000110000001001000001000000110001100000011001110011010111000100000000001100101101010
10000000000000000011000000010100100000011000100000000100100011110110010010010001000010000000000000111
01101000100001000111010001000000010010101000000100001101000000000001100001000000000000000011100001000
00010000100101100000000000100100000001000000010000000000000001001011001000101000100111000111000011000
01000000010100000100000010001000000001000100111000000100100100010010001011100110001000000010101010001
00101100110000100000100000010100001000000110001100010000001001111100000110001001001010000000110000100
00001000010001000100000011000011000111010001001111000000000000111110100000100001000110010010100100100
