00100100000000001110001000110000000001101111000000000001101111110000001110110110000100000000101011111
00001000010000001100011110000000011101000001001001000000001111001100000000000010001000110001100001110
10000000000000001000001111101000100000000011100100000110001111000000000100100000000010000000000001100
00101010001100101000000111100000101001110000001000000000101110001000011010111010010111010000001000100
01001000110000100000001111100101001010000110100000010001001111000111001010010001001111010101110110000
10010000110000010010001111000100000000000000000001000100001111101111000001000010010110001000000000011
00111001010000100110000010101010011011100000000000011001011111101000010010011001100001000001100010001
00010000010101000000011010000011111100000000000000101111000001111000010001000000101001010000000000000
10010000111001110101010001001000011100000000100001000001000000100000100101000111111101101010000111010
10001100010000001101011000110000011110001000001000100000111000110010110000101011111000000110010001000
01000000000001101001001100000001001000001010100001000110000100100000000000100001111010100000011110011
00001110000101000001011100100000000011000000010001010000000011000010100001001101100000010000000010111
10000111000011011010100000001000001010010110011000000000000010001011111000000000010010010101000000011
01000011010010011110110101001101000101001000000101001100010010000111111010100001100000000000010000111
00001011110000100000100000100010100000000001000010011000100100110011111110001000100000010100101000001
00000100000010000000110010011100010000001100100100010000000001111001111100100000100001101001101010100
11000000100100000001100010000000001010011110000000101011001001100011011100000011110111001001000000000
00000000001001110000000110001110011001011101100101001100010100001100000100000010001110000100001010010
00000001001010000010001000000001001010001000001100000110000000001110010011000000100100010000110000100
00001000100110001000000010010100011100101100011100010010000000110111110000011000100010100110110111110
11111000001010111100100111101001001101000000101001000010000001000110000011010010100110010000000000100
00000010000011111110100010000110011110000000000001011100100000100110000000011100101000010000100100100
01001000110011111101101100100011000000010011000000000000010001000100100100000000000100000000101000000
10010000100111110100110000100000010001011000001001100111110001010010100010001010011000100010000101000
00010000000001100000100011001001000010101000010000010001000101001000001010101010110000000010011000011
00111010000001001100000100000001010000100001100010000011110000001010000000100000000100001000010000101
00011000001010000000000000111010000001001000000100001101000100010000101001110100000001000110101010001
00110001010000000000010000010010100001010001001010000100000000100000000100100110000001110000001010000
10000000001010001001000000100000101110000011010000000001010010011100001111001010011001010100000101001
01000000101000100000101101100110100000100100001001111001010000000001111111101000001010000000010001001
00110000100010000011000000010000000000000111110001000100110001100011011110000011000010001011000101100
10101000100000000000010000001011101001000011100000000011000000000001000100010100000100010001011000010
00001000000111010100011000000000100001111011001010010100000000001010100001011000001111000110001100011
00011110000111100001010000001110001101000010000010100000010001000000011011101000000000000010010010101
10000000010011100010010001110000100000100010100001000100001011000001100101000110100000110010000010000
01011010000011110010000100000010001000000011001011100010000111010000000001000010100000100111010110000
00000011100100100010100110011100100011100010001100010000000000100010001110000110110011000110000001010
10001000011001001000000000000010000011110001000010000000000000110100010010101010000100001011001000110
00100000100010000001000001000000011000100101001101101001000110001000111011000000101100110000001110000
00010000110000000100010100001011000110110000000000111110001100101000011000000000101010000001100100000
00010000000000000001000000101100001000000010001101111000001100100001001000000001100000101000000100000
00011010100001100001100100001010001100000000001100000010100100011001100100001000101000100000000000100
00000001111110001001000100010000010001100100000011100010000000000000000100001101000000010001000000001
00011010000100100100000010010001010000000000000000011010010010000010011000001000001000110010000000011
00100000010011010100101000000000010010001000011000010000110011001000000110000001100000010100011010000
10000100000000011000001000000011101000010000000011110110000111011000010010110000000010000100100000101
00000001010001100001000010010000000101010100010010000000001111001100101000010001011101000001000000101
01110001100001110000001010001110010000111011000000000011110000000001000000111100011001011110000100100
10000100001100110001000100001010001000000000001100110010001010000000000100011000011001001100010100100
00000001001000000111010001001000100100011011000011100000001000000110000000111110000000010001101010100
10100100010010001000001001000100101001111001000001100000111010001110101000011000001011110110000000000
10000000100111101100010100000000010011010000000000001100000000100100000000000011000011100001000110001
11000100100010110011000100101011000010011000010010000010010010110000001000000011000000100001000011111
11000100000110001001000110110000000010000100001001000000000010010001010100011000001000011011101100001
00000000001000100001010010000100000000100101010000110000001100110000000111001000100100010000001000101
01000110000000010010011010000000000000010100000010000100011100001100101000000000010000110010100110000
11110000110001001110111100100000000001110000000010010010100010010011111001100010010000110010000000101
11000010010100100100011000101010000110111010100100000011001011100011101000101010100011110000101100001
01110011100010001101000010001111100100000011001000000011110010000000001011001010001000100010000010000
00100001100000100000010100010000000000010000010001000110000011000000101001000000001001100000100111100
00010001011000001000010000011000000000010100000100010100000100000100000000010100111000000000000011111
01100000010010000100000100001001000001100000000000000010010001000010100101011100100000011001100000101
00000001000010001000001011010000100000001011000100000000111001110100110001100110010001000000010100000
00010000010001000001011011000001000011100110010000100010111100000010001000010000010001000001000110010
01110000001010111000010010000000000000010100001000110000011100110000000001101001000000100000100010001
01110000000110010001001000000000001010001110000000011000001000100110000000101000010010001010100000000
00111000000000000000001000001010010000000000000010101111000110011111000000000101000001000000000010000
11000010100101011000000000000000000010100000000000100010000011000010001000100101001111100101101100110
11011100000011000000100100000010000000101000000110111011010100001000011110010111001110100011000000000
11111110000010110100000010110110000111000001000010001010011000001000000001110000001100001100010011100
11111111111110000001000100001001101000000010010000011011000100000010010010000101000100100100101000111
11111111111100000111010000011000000000000000101001011010110001100110000010110000101110000110000010000
10111111111000100001110000000001110110010000000110001010010010110000010001000101010110110000010000000
00010011111110110010000001011011100110000000000000001000000110001100000110000000000000000001000001110
00000011111101100001000001000100000001001010010100100000000100001001101001001000101100100000000011100
10000100111000010000001010100000000010000010100111000001000010000001000000000110001100000001101010001
10000110010001100001100000000101001001000000101001011000010001100000000000000000100101010011000001011
10100011000100110000000110111010100000001000010010110100001000111001000000000100000000001100111001111
11001100000010001000000000000010100100110000110000010110000001000110001001001000111001000100000100111
11000001100010010010011011100000010000011100001000100111001110001110000101010001100111000000000000111
11000000000110000000000000001000111101001000000000010001101001100000000000000001000011011000000010101
10011001000010010001101001101000110001001110110110010010011000000000000001001111100011000111100000100
00000011011100000110000000000010110011100010111100100000000001000011000000111001101010000001110000000
11001000000000010001110110000110000000000110000100100101010010010010000010100011000101010010110010010
00001000010010000100100001100001110000100000000100001000011001001110100000000110000000111000100010000
00001000001000111110000000100001000100110111010000000010010100011100010000010011000000010101101010000
01100001100000001101000000001001101001000100001010100011010001001100110010110000000010100100001000101
11000000100000100101000100000000100110100000010000000000001001000001110100000000000000001000111000000
00110000101000001100110000000100001000110010010100001000000001100100100000000010100001000010000100001
00001000100010011001001001000000010110001000001001000100000000001100010111100000000000000010000000000
01101110000000100010010000011000110000100000000010101001001011110000111110000110111001101001011000001
00011101000101000110000000001000000011100101000010000001000010000010011000111000100001001000000010100
01111000111001010110000010010000110001000011100100100101000100001000110000010101001000000000000111000
00000010111001010000101001111000000001100000010001000101111010001000100101000000000010000110001111000
10001110011000110000001000101000010000000010000100100000000010010000001000000110000001101110101101101
00101101001001100000100000001000001110000101000000001111100000011000001100100001010000000010000000000
00001000000000010000100010000011000000110100010000011111000100001000010001011011100000000000110001000
00110000001010110000000110001111100000110000010000001110011110000001000100011011000001100001010101000
00000010100000010010001111000110000101010010010110000100111111100000110000001100011010000010000001100
00010100000000000101100100000111010111000001000000101000011111110001000000100010111111001000100010001
00010010000000100001000101011111110110001001000100011011111111111001000000001111111110000111000010100
