00100000011111101000010000011111000111000001001110010011000100110001000100100000000000101111001001111
00011100011111000001000000100001001001100110001000000110000000010000110000000001111111001110000001001
00010000001100011001110000001000011000000110110100001000000000000011100000000001010000010010000000100
00011000000001111110010011000000100100110000100101000100010110001010110100000011010000010000000001000
00010001000010011000000000010010101110010000100001101100011000000010000000000001001000110000000000000
10011001100100001000000101001011100100000101100010000000111100001001000001011110000100010000000001000
10000000001001001100010000010001000010000100110000010011001001101000010000100000100000001001010000000
11000001100110010000010000000110000100111110000100111000000000011011011101101010000101100000000001100
10000000110011000010100000001111001000001110101010101000100010011000100000001000011111000000001000100
11010001110010100100000000000110100110100000000010000010010010000100100100110000111110000111011000000
00000100000010000000101000110000000010100000000000010001010000000100100001000000011110000010001000111
00111011000000000010110100101000100000010000100101100011000000010000000101000001001100000110100100111
10011001101100100000000001100000100010011010000000100000000000010000011000101101001000100010001000111
00000000000000000010001100001000000100100001000001110110001010010000100011000110101110000000100010010
00010011000000000010000110001000001100000000001000000100001100110010101000010010001010000000000010010
10000001110000001011000101111000100011110101000101010001001110001110000001100010110001100100000000100
00101000000001000010000000000000000000010000010001101111010010001110010010000100000010001000000000000
00001011111010000101000100101000100000000100000000000011000110001100100000000000100101100101000010010
10111000000001000000010000001000011100111110101001000010011000000001000001001000001100011100110010010
10111000001000110100000100100110000010000100011100000100001101011001001010000001011101100000011000000
10111100010010110100011011100001001000100001111001001010100000111110011000111011000000100101001000100
00011000001001100001000010100000101000000010000010010010001000011000000100010011000000000000010011101
10001100010110101000001000111001000011010000000000000010011101001001010001100011111000000010011000000
00001000110100100001010000101000001000110100100010000000001011111000000001011001110100000001100010010
00101000000000010001010101000000010100001000010010000000010000010000000010011000100100000000100000000
10000011010000100100010100100011100000001111010000000000010101000001010000010000100000001100000000000
00000000010110101010100000000100000011000001000011001000000001101111101100110101101010000000011100001
00001011010111000001000010100010010110001010000001010100010111100000000100001001110000110001101000000
00100000000100110011001001010000100000110000000010100010000010000000100000000111100001000100000000100
00000010100010010010000100010101001011000100010000011011001000001000011110100011000000010010001000110
01110001000000100110010010101000000001001000011100010000010000110011100000100001001100010000100100010
01010001010110110100101000100010100110101011000000000001110000010000100000000100100000100000000001001
00000001010000011100001010000000001000000000110011100000101100000000001011011100000011100000010011010
01011110000010000010001100000000001000001011111001101011100001000100001010011100001000010000100010000
01011000101010000100000000000000001000000110010000011100000000000010001011010000010000101001000100100
10010001100001000000100101100100001100010010000010111001001000100000000011100010000000001000000000010
11010011100000010000010100101000100001000110001010110000001000000010110111111010010100100010010100011
11100000001010101000001010110000010100010100001000111010001000000000100000000111000100000000001110011
10000011000001000001110000110000001100010000000000011110010000000011000001100000000010100011000111011
00000010010001001101111000000010100000100000011000001010001000010000000001110000011110000010100010111
00001110000000100000100000000000001100100000011000000001000010000000010111100010000100010000000000011
00000100010100010110000001000100000100000010000000000000000100101000001001010001011010100000000000001
01000000000001000011010000000100011010000000000010100101001111000000000000010010000000000100100011100
00010110110001000110011010010010000010101110001000000000000110010000100000100110110000001101100011000
11100000100111100001000000101100001100010001100110000100000000010001011000101000100100000011111001101
11110000001001010100111010001000010000000100101100000000110001000101010001000101000000010000001000110
01110100010000010000000111100100101000100011000000001100110010000001010101001111001101010000000000000
01100001100101000101000111110001000010000110000000000100000000001000000000001110000010000000101101001
00110000100001000110010000100100000100001011000110000000000000001100000010001110001000001000001001100
00011001001010001000010100100100000000101001000100000000000001010000001110111110000010000101000101001
10111001100111000001100111100000110100000011000000100110000100100111100110111111000100000000000100001
10010010010010000001001111110111000010000011100000011001000000110100000000011111110000000000000010001
00001000100100011100001111110000001111100001000000000100100001010000010110100111010101000010110101001
00000100000011001110001111111100011111101000001000010000110011000000101000110000011000001111100000101
10000000110000101100001111111110000101100010000100001000000000100000000001100001000001001110001000001
10000100000110000111000111111110000000010000101000001011100001100000000000100000110100001101101100001
10000000100001011000110000000000000000000000000001010111100100000000100000001101100100001100010000100
11000110000000100010000110010101000000111110010000000111110101001111000000110100001110000010000100100
11010000011000000000000010001000000010010000000110000011110010000001100101000000101111010001000010100
11110010100010000011100000000100010011010100000111010001000010101000010000000110000110000000011000100
11100110000100100111011101001010000000001001001001100000000100100010000100000111010100010000000100000
10100000110111000010000000001000100001100001000000011100010000000000100100010000110110000000000000001
00000011110000000100001101010000110001100010010000001100011001010111110001110000000000011000100100111
00100000001001000001001100010000010110011000100010001100100000110000100000111010100001010000001110111
01110000100011001000010110000010110110110000100010100000100000010011011010111101100000010001001111111
10101000000001011000000100011110101100000000110100100011111110010100011000000000000010101000100011111
00000010000100001001000011001110001010000000100011001001110000100000010000000001000011001000000000111
01011000000100010011011100001100000000100001100010000111110000100011001000000100000010000010000000001
11000001101001011110000000000000000001111001010000011001110000000001000110010100110000000000100000001
00000010000000000011001000000111010010100000000011000100100101000001001100000000001000010100011001101
00010001100000010000011010100111000010000000001011001100001000011001100100001100011110000010100111000
10000011000000010000100100101110100000000000000010000000000110010000000000100000001101001010001000000
00100011100000100101110001001100100000011001001100000001000001001000000111100100100000011011000001101
10100001110000011000100000100000110010010001000000100000110000000001000111000110100010000001000000000
00000001110000000010010001000010110000001001000011001000000010010001000000000010000000010001000100010
11000100101001100000000001100010001000100000000000111100000000110000111000100110001000010000100000001
00000000000001000000101000001000100010000001100001001000000000100000100010010000000010001000000110001
11000011100000001000101000110001000100110000000110001001101000000000001010111000000000000000001000000
00110011100000010000100001000101100000001001000101000010100100010111000101000000000000100010000100110
00001100000100001010000010000001010000101000000000000100000010001000001000000000110000001010100100100
10101000001110001100000111000111000110111101100001010110000101001010010000100100100000000000100011110
00100100000000000100010000000000010010001011000000101000100000110000000000101100000000000001000100000
01000000000101000001010000001100000000000010100011100010000000000101100000010110010010010000100100000
00111000001111100010000100000100000100100100001000010000001110001000011000000010000000001100100001000
01110100000101000001100101011010001000000000101000101001100000100000100110000100000001000000101010100
10100100000000000000000000000010000000010100001000100100011111000011110100011000010001100000000100010
00000001010000001110110010110011100000111000011010001000000011011010000100000111001001101001101101100
00101001101000100000111100111000000010110000101000100100010000011000000011000100001000100001110000001
00000010000011111010111100010001100000011011000100010000111100011000001100001010000000100000111001000
00101001010111111111111010001001110110110011000000101000000100100000000100010001001000110111000000000
00101100000111111111100000000010000100000000000010000000001101100100011100100010100010010010001100001
01000110000011111111100010000111001001000111010000011000001100100100100100110110000011001100000110000
00010100110001110011100100010010000000110011000001011010000110010000000000100000110110000010000000100
00000110110111001001101010100001100000001100101001100100100001000000101011000110100000100010001101000
10011000011001010000101000100000110000001000001010101100000000100000010011011000100111000100000010000
00000110000100000001000000000001010000001000001010001001010000111000010011001111101000000100100111000
01000000000011010000101100010101000001001010101001000011001000010001011110000011100110001010100010001
10000100010010010010010001000100011000000110000011000000100000000000000000010111100001000010101111001
00011010110100000010110001001001001001011000110100000000000110010000010000000001100000100000111110011
11001000010010000001000101101011100000010000010000000010000011111100011001010001100100100100111111111
10001011100001000000000001000011110001001000001000100100000111111111000011100011110000000001111111111
