01010000111101111111000101001000001001000001000000001000000000100000011110100000000000000000111010000
00000001000001111110000000000010100100000010101010011100000011001011001110101001000110100100110000011
00100000010011111100100001100110000010111000001100011101001100100011011000101101010001001000000001111
00001001000001111110000000100110100100100010111000001000010001001111100001010000000001101011000000001
01000100000011111111001011000010000000101000110001001110000011000000100001000000110000000111101011000
00000000010111111111000000100001100001110110000100000000100110000111101000101101000010000011110011100
00000010001011111001001000001000111011110000000011100000000010000011110000100000000010100001111110100
00010000000011111000000111101001001001100010101111110110000011001001000000000101001000000111011110100
10000011101111010100011010000001010000100100001111111000100000010000100110000101001001100111000000000
11011000000010000000101000100100011000111110001111111101000000000010001001010011000000000110010000010
10011010000001010010000101000100001010101000111111111100010100000001100010000000000100000000001010001
00100110110101100000000010010000011000001000011111111100000001001001000011011000010010111001000100010
00100110000100100000000010000000001001100011001111111100001000000001000010011010100000010010001011010
01100000000000000100000010000101001001100000010001111110000010001000100000000110111110000100001000000
01111110101001001000010001100111111101000000100000111000000000100100111000110111110100110101001000111
00111000101001100000011100011111111100101001000000001101000110000001100010000110100000010000000010000
10010100010000000000000110011111111000010001000011001110000110001100000001011000011010100100100010101
00000010010001101100100000011111100100010000001000000100110010010100101111111001000010000010000010000
00000100001000100010001010111111100000011110001001001110001111000000000011001000000110000000011000100
01001001000011010000010011011000000000011100110000010000010011110110001001011010001111100000000011100
00000010010000001111110100011000000100111111010100000111010100000010010011011000001111000000000100010
00111100000001100111101000001100000101111110000100000110010000001110001100000011101111001101010000000
01111001010010000111100010111100100101111010001000000011000001100001100011010000100000110000100000001
01110000110010000001000000011000000010110000100000100010010100001100011111001010000010000001100101011
01110011000100000000000100000000001000000000110000000000101100100000001111010100000010000100001000011
11100111011000011000100010000010000001111101111000000000001101000011001011000001001001010010001001011
11110111000000010001001111000000000111101001010000100101011000001100010001100011000001111000001000001
11100000000110010000101011011110001000100110000100001000110110100000000001000011100110000100100000100
00010100001010001001001000110101100000010000000100010010000000100000001001100011001000000111101001111
01010011000010110000000001100100100000001010100001001000011010010011000000001010000000101111000000010
00001001000000010000110011001100100000000010001000000000000001010001100010000100010110011110100001000
11001001000011000001000101001000010000100001000111000111000011110011100001100011000100101100000000100
10100000000111111000010000100010100010001000000000100101101001000101010010001001100011001000010000110
00001001000111100110101100010000000000000011110100000000000101110100001000001011010000000010111000000
01100011001011001010101110000010000000101010010000000010000001000010000010101001000000001001001010000
00000011110010011011101111000110000000000000000000000000000000000000000100110000000010001011001000101
10000011000000001000100010001011010000010010000011101100000000010000011111100000010000100100000000010
00010000000000010001010011000001000010000010000011111100000000000010010001010000001110000100000000000
00101010000000110000000000001001000010000000000000000000010000100000000000000100010001001111001000110
10000000000001011000000011000101010001001000101010000011000001110000000000001000000100000000110001011
11110001000000001100010110000001000000000000000001000101010100011010000101110111100100000111000100011
00101000010001100000011111000001011000001000101000000001111001000001100011000111100011000100000110000
01001000100100101111000100010110000001110010000010011001011000010111100001100011000011100000000000001
00100000000000000100000010000000100100100001010000100010000001010001001001000001001000000111111000001
10001100101000000001000000000001000010000000000010001000000010011000000010010001001000100000010101011
00010000000100110111110000110000000000010000111100010010101101001000010011111000000001100000100100100
00011100000101100000111100000010100011110000000001000010000000011100110000010011000011110010101110001
00010010100000001000110000000001000000000001000000000000000100011100001001100100100011100001001100111
10100000100000011111000110100110000000011010101100000010110101001000100011100000000100110001011101111
01101001010000001000000001100000010010000100100011100000000000100001001000000101000010010000011100000
00111101000001100000010000011011000011100010001101000100010001000010001010001010000001000001001101100
01001101000000001000100001001011100010000000110100000000000011001001000100100001011101101000110000100
01000010010010100000000010100111001000000000000000100110101110000100000000000100010101000010010010010
00010010100010010100110000000000111000001010000000000001110100001010100000001110100001100110010010100
00100100010010000100001011010000100000001000100000011111100001001001110001000110000010001000100000001
10000111001110000000001100110110011001000011000110000101101101011100000100000000010001000010000100001
00110110100000001001010000001000001010011000100000000000010100101001001000100011000000100000010110011
00000010110000000001011000111010000101000101000001001101010000100000100000010111011010000010011000111
00011000000110101001000000000000100000000011010000010101000100011110000011001000111010000011011000011
00100010110101001010101100110111000000011111000100000110010000100010101001001110000100000010010100000
10000100010000010000010000011100001001000000110101000000110101101000001100000110100000000110100000001
00010010000110110100111100111011001100010001111000001000100000000010000100100000010001100110100000000
01001000001010101000111000011000110001110101111000111101110111100000000000000011000001110000000000011
00001001000000100000110100000000000100100000100000111101101010000000000100000000000011110010100000011
01110000000101110110000000001001000000111000000111111000000001000011100000100011010101000000001100000
01100011110010000000010000100010101000000010000000110000000011011100000011100101010001000000010000101
01001000100000000010010000110000010011100010101010011101000001000010100000100000011001010000010100110
00001011101101000001110000001000000001000010100001110100001010110001111100100110100000100000001000000
00110000000011000100000010100000101000000010101000100000011100110111111100000001000010010110010000010
00000110000101011100000100100100010011100110101101010010101000111111111101000011110010000000110001000
00100010110100100010001000010010011010001010000101011000001100000011111100000111100111000100011000100
10000110000110000100000101000000000000000010011110010110010100101011111010000010000100011101001010000
00100001000000000001101001110111001000010000000110100001000000110011110000001100100000101000000010000
01100100101000101011000110000001100000001001100000000100100001110001000001110000000000000100000000100
01001001110000100000010000110000000101111110110101010000000000100100001000001001110010000001100000001
11000011110000000010100000100110000101101010000000000000010000000000011110000101000001100011100000001
11100001100000100000010000000010000100000000000100001001001010010010000000110101000000010001110000010
10000010000100100001000000011001000001101000000100000000011110001000001001000000000000000001000101110
10010100000010000000000001111100010100011000001001000000000110100000010100100100010000100001011000000
01000010100110100010001110000000000001100000010000001010001001100000100000010000100001110110000111010
00000110000000110000111111101010100110000100001011000000000000001100000011100100110000100000000001100
01001001100000011000111110000011100011010011010000010001100010100001010001110101010000000101000011001
10100001100001100010011111100000000000110010010011000000001010001101000000100100000001000100000000000
10100010000110000000100111011011000010001101010001000000000001000001100001100000111111001110011101001
00100000000010010010001010000001011011000101000011100110011010111100100101110010000011000110000000111
10001011011110100000000001111001001111111000011101000000100100101000000000100000001001011111100100001
10001100000010000000011000000010000010100010110000010010100100100000000100110001000100001110010100001
01101000111100000000001001100000101000100000000000100000000010000001000010000111101001010000110010000
01011011000110100000000000100001001000010101111100101011110100100100110100000111000111000100111111000
00001100000001000000111111110011100000001011110011011001000011000110100000100010011010000110011100000
00001010010000000010000011110110010100010011110000001110100001000010000010000000100000000010100010101
00001000100011000000000011111001010000110001110000011100010000001000001000000000000100001010010001000
01001010010010001100000011110100001010000000110000011100010110110000001000000001001110010000110001000
00100001000010110011001101000001111010100010100110101000111000000010100101010100010101010000100000100
10100100010000101000001101010000000100000000010000000010011100000010100001010010000000000010100001000
00010000111001001000010001001100000110100011111100100110100000001101100000000000110110010000010000011
00001000100000000000100000001000111111010000000100000001110101011001110100000000010010011100000000001
11011011111110000101110110100000100100000001000000001000100010011000010010010000110100001110000100010
10001000110000100000100001000000100100000000000000000001111010000001100110101000000010010011001100000
00011001110010010000010100001000000000000000000010111011111111011011111000100000101010010000100001010
00110001111010111000100100001011010100110010011000110011111111111111110000000000000001000010101000001
