11111111000010000110000000000100000001111110000010010001000001010000100011000000000110001010010000111
11111111000000110000100000000000000000111111000001011000001000010001110010001000110000110000011010000
11111001010000001010001000000001001000000100000100000000010001001000000000000001100000000000010000010
11111000001101010011010101000000000001101100000011001010001001001110000011100010100010001000100100001
11110010000000110100000010110001000100011000000110011000111100010000001000001000101000000000011100000
01000100001101000101110000000011001101000101000000000001011111011100100000110000000100100111111000001
00010010101001011110010000001000001010110101110000001110000000001010001000010000001010000000100100010
00001111101000010010000000000111000000000000110000011000001000000000001001010000110001100000010110010
00010010000000000000100000011010100111010001000000000001000110000110100000001110100000100010100000100
10100000010001011000101000000000000001101101101000001000000000101011001000001100000011101010111101000
00000010010101100001000000001001000000000000000000011010101000100000010001101001011101000111000000001
01010100100001001000001100000101000100000001000110010000000110110100010001110100100000000010000000011
00010000111000001100000110100000010000000000100100000110000000000001010000100001111000010000000001001
00000000010001011010011100000110000001001000010000010001010100000000000001000100001000000001010000000
00100001110000100010000100010100001100000011110001101000001101000100010000111010000000011000100010010
10000011110101110100000001011110000100010010101010000111000101000101000010000010100110011001011000001
00010101000000100000101000000000100000000000100001001011000101000001001000101001011000011011000110001
10000000110000000000011010010001000000001001000100000000111100100101100001001111010110000100001000011
11000000100010001001100101010000000100000100000000001000000001101001001000100000010000010010100100011
11001001101000000001000000100000010000010000110011010010000111010000011000010101101000010100101110001
00000000000011011011001101001111010001110010100000000000010011000001010001001000100001110001100000000
10000000011010010010010000000000001001001000100001110110000000011000010000111100100000110011001101001
00000110110000000110110000100010000000010010100000110010000001000000001000110001000001111001010111000
11000011010010111110010010011000010000100100000101000100001011100101001001000011001000110001000001011
00011001001000100110100000011011010000000000001001100000000100001100010010011010010100001110000010000
01000011100111000010011101100010000101001100010000000000110000000001010111100000000000000000010011010
00111000100011100100000000100000000001000010000011000001001001001010000010000000010001001011100011010
01101000000001101110101001000000000001000010010100000010000011001000000000010000000000001100001111000
00000000000000000111000101000100000000100010100011000000011000000100110000000001000110000001110000110
10100010011000001000100011100110111011001010000000010010110000010010001100000001110101000000000001000
00001000000000101001101011110001101000001111100000001000101000111010011001010000000100001001101000011
10001001100000001000000101011000000100000000001000100010001010000001010000110110011010001000110010111
01000001001001001010110000000000000010010001010000010100101111001011100000000010111001100000000010000
00100001001111011100000010001111000110010110010100000010001111100011100010001010010000001101100101100
00001100100000000101001100000100011000100000111010001000111111000011100000000111100000000000101101110
00001101000000100001011000001000001001100101110000000000000011000110010110100010011001101001000001111
01001000000000000000000000000001001000110000000010001100000000010000010000000100000111000100110000110
10000101100011011010000010000101000001000111001000100101000010100001000001000011100011001110010100010
10001000011101000100101000001100001010011100011100100010001001100001010010001001100011100100001100010
10100000010000000010000000110011100010001100100000010001110001001100000011101111001101100100110100010
11010101001001010010100111000000100000010001001000010001101000001000110000000010000001100011010000000
11010100010111000001000101110000100001101011100000010010001011100000011100010000010010001000000100000
01000100000100100000000100010110011000100011001000000011010000100101010011000000110100100001000010000
01001000010000000000100001100001001010001000000000001011000010000010010001101001000010100000010001000
00000001000000011011100001100001001000000000010000100001000110011100100000011100100010000000111000010
00000001001001100011010010110111000000000111100010010101010011000111001101000010110100110010000000010
00000001010100010110000000101001011000010000010001000001000100011111100101001000010110001111000111000
01000100000000000001000110000000000100010001101001010110010001000110100001000010000011000111100001010
01000110010000000110010010000100010001001110001011111000011000010000100101000000010010000001100010011
00011001100100000101000011101000000101100111000001010010001100001001110100111000111000001101000000001
00001010000000011000100010100101000100001101010000000010000001000011110001110000100111011001010101001
00000000001001111010001000001100011000000101100000100000010010010111111011111001001000011010010000011
01010100010101010000000000010001000000111000110000001100010000000010010000110101101110100010000001000
00100001000001000101011110100100000010111001010010000010011001101000001100000000001111101010101000010
01001111000001100100000001000001000011110101000010100011000010010000010000000000001111110000000001010
00000001101000010011110010000000010011110000111000010000000001000000111101000000111111111001010000011
01000011000001000100000010000001011001111000110000000000000001100111000000000011001111010010110100000
11101001111100010000000010001001000100010000000010010011100100101000001000111000100111001010000000001
00110111000000000101000000110010000000010000000010011000000000001100000000000100100111000010000000100
00000111101011000000000110101100000000100011010010111101001010100000111000001101001010011010010000100
00100001010001100000100010000011110000010101000000001111010100000100000000000000011000001001000000000
00000110000100000001101100000001000000100001011000000111110000000111000001011000000100110000001010000
00111000011000110101100010100010010000101100100000000001000000000000010000100001000100000001000000101
00000001010000101011000000000011100011001100010000100001100100010000000100100001000010000000011100001
00101010000101100001001010000000000000110001001000101100100100100000110110010000001010011001000001000
01100000101010100100110010010101000101011010000001000001100000001010100001001000001010000000100011010
00100100001010000000001100110011000010011100000100000000110001100111000111000110011100110101000100000
11000000000000000000010000000111000000001000011110001100000001100000011000001100011001010001010011101
01000000110010000000010010000010110001010000000100110000111101010001001100001000010100010101000100001
00010100000100001000100011001000001001100001000100110111100000010000010001000101110000001100000000011
01001000000101110100100011001000000001000010000000011111001010001000000000110100110010010101000010000
00010000000000000100100000000100001001101000110000000100000111000001000000001110000111000001100001000
00000010100011000000010010000000000000100011110110001000010010000011100001100100010011000100101000001
00001100000000110001100010111010100000110100100001111101000100000001100111001110000010000101000010100
00000101110010001001000001111111110101001001000100000110011000010100001110011100100100101011001001000
01100001001000100010000001001110000110010001000110100001000000000110110101011110010000011000000000100
00010011010000001000011000000110000010000010000010000110100001000000000001001000100011010001111010100
00010100000001000000001000110001010000000010100000010010010001000001000001101000100110010011110010100
01000001110010001000001010010001000010001001000110110001001000000000000000000000100111010001100000001
10010001100000011101011110000000110110000010001111000000010000000001110101010001011001010000000000101
11000000011101011110001000010010100010100010001111100010001000100011100000000010000000000001000001100
11100000000101100010111100100100000001000100011111000001010000000000000010011000001010000010000000011
11110001000100100010111111011110010010010100001000000101010010000101011000110001010100000100001001000
11000011000111100000011111010100010000000011010000000000000100100101001001000010000010100001000001100
11110001001100000010011110010101011010101111110000100000010010001001100100000100010100010000000111001
10000000000101111000111101000100000000011011111000110001001011000101000000110011011001100000010010001
10100000011010000000011100011000100100000001110010101101011110000010000100100011110001100000000001100
00000000001011000000000010010110011110000001100000000100001001100001000100100001100010000011100110000
11110100010001000100000000010001001111000000000010100000000100010010000000111100010000000110000000000
00100000000101010101000101011000011111100001000011010000011000100110000000000000100010010010101000000
10001001000001100100110000001000001101100000111000000010010011001000100010110000000011000100010001101
10110100000000101000100000000000001000000000110100110110000010010010001000100111101110000000011000001
10000100100000010000100000010100111100011100000001110001101100101000001000011110000000100000110010100
00000000000000100100000000000000000010110000100101100000101010000001011100100100101111000110000000000
10000100000100001110010000000101100100100011100000111000000011000000001010001111101100001100101010000
01000010000010000100000110000011101000000000010010100110110110011000000000000011011001110101001011001
00011100000001001100001001000000000000011000001001100001000101110011010001010001011100000011111010000
11000100000101000000001000010100000001000000101011100100000100001011100011111000010000010000100000000
00010111000000101110010000010000010010001010000101100010111001000001110010010110001000000101100100100
00100111111001000010110000001000000010001001100001010110000000100111110000000000011000000000110000101
11000011000010000000010010001011110001000010000000001100000011001111111000100000100001000000110011001
