00000000011100111111111100001000000100000100010000010100111000001000100011111000000000001101111111100
01000100001000111111111110000000011000000010010000000101001000101010010100010100101010010000111111100
00000001110010111111111100000100100111011000000100010000000000001111000000000000100101000101111110000
00010010010000111111111100010011001100110000000000011011000000000000010100000001010100000001011100010
01000000000010111111111100110000001001101011000000101100100001000010110000001001000001100001001010000
11110000001011111100101010000000001000101001011010000001001000110000000000001000100100010000001011000
00000000101011111000000010100000000000001000001000110001101000100000000001001110001001000000000001000
00001010000100100100001000100001100111010110001000000110011010000000111101011110010100110010000010100
00001010100010001000000100010100100010000001000010010000100000010100100000010100100000010000100000110
10000001000100000001001000001100100001100010011000010000001100000101100001100100000001001000001000100
10000110000111001000000001110000000110001000100010000011000101001110000001000001100111100111101000000
10000111010001110001010001011001100000100011011000000000000010000000010100001000001110000100110100001
11001000000000010000001010000000000001000010000000101001000010000110010100001111011101000010000000000
00000010100010000100000011001111110100001111010011010010011000100011011010011111110001110001001010001
10000010100001100000010000000001001000100010000001000100000010101100000010101011110000110100100110100
00001010110000000010000000000001000100100001000000101010011000000011001000000011000000110001101100000
00000001000000010000000001100001100001101100001010110000100100000001101000010010001001001101001110000
10010010110100000011000010000100100100000000000100010100010000000100111000100010000001100000000110100
01100000000000000100001010100000000110001001000100111000000010110001001000010001111000110111000000100
00000001100100100000011011000000000100100100000000011110001001001010000000000100001010110110100100010
11011111111000000000001000000001110100100000011000111000100000010001011011111010010000001000001101100
11111101100010000001001011000010001000000100111001110010010101101001100110010001001100000110000000001
11111101000000000010001000001100101010001000011100100001110011100000101100000100010001011111000000100
10111000000000011000000000001001000010011111001010011001100111001000000100000011000100000000000000001
00000000000010000001001110000011010000000000001000111001010011001000000001000000000110000000011110011
10011001001100001100000100000000100000100001000001001000001010010000010110010111100101000010010001111
10111111100000000100100000001001110110000100000000000001010001111000000100010001001100000000001100101
10111111110100101001000000000100000100000100101010100101000010001001001110001001001011000100010010000
00011101000010010001100000000001010100100111000001111000100000111001000101011111000001110100000110001
00111000000010011010000100000011110001010011000011110001000100000000000100111000101000100001010010010
00011110000001111010001111100011001001000001000010100001000000111010000000010100000001000000110000000
00011110100000010001010000100001010011000010100000011011110110000100011010010000000000010101000001000
01111100000101001001100000000001000010000010000000000011111110000000000010100110001101010001100001010
01111110110011001100100010000100000110010001100000011000111110100011100010100000000011000110000000000
11110100001111000010001000000111000000000000100010010100011111010000000100000000000001110000110000001
11100100000000001000101000000001001000110000000000110000011010001000010100001000010000011000100000101
10010001001000000011010001001010000010101000011010010000010000001101100000000001111101011000010010000
10000000110100010110000000110001000001001010110001111010100000001010011000000011010000101010001000101
11000110000000100000100100000000000001000000000000100000000001011000000010010010000000000000100010110
11010000000001000000001001001100010000001010100001100000111001000101000010001110000110000100000100000
11100001000010100000001010000000100000000011000000100010000000100100100001000011010000010100101111000
01100000001100000001000000000000000001000000100000000110100010000000010000010011010010000010001100010
00000010000001011000110001010001011001000111001100110000100000000010000000100001000000101100001010000
10101111000001000101111100100000101100001000111110001100111000000010000001100110100001010011000010111
10000011010101010000100000110011001010101110001100101100000100101000000010000000001101000001010000000
00101000000110010011100000000001000010001010100000000001110000000001111100111010001000100001001000000
00011100000001011000001100001000100001010011000010101000100010100100111001000000000001010000010011101
01000010000000100111000100001000000001010001001110000110001010000010000001010000010000000110110000000
00010000000000000001000011100000010001001001000110000000010000000100100010000001000000000001000000000
00101100000011001000001010110000100000001000111000110000000111000000011100101100010001000101110111001
10000001010110000110000000010000001100100010000000000101000001000101100010011010010000000000101000111
10100000110101100101011100110101100110110000000010100001010000001100000100000010110001101010001000000
00000010010101000000000000000000011000010110100101101100010101111110010100000001000000000010000011000
00010000001000000000111001001100000000010010101100000110010110101110001000000000001000000000100001001
01000000111100110110000011100011000000010001010011000000001110000100100010000010000010000000000000111
00001100001010101100010000101111110000110000000000010000100100100111001001000000001001010010101001101
00010000000000100000000110010000010001111000101000011000000010001000100110001000000001000110101010000
10000101001000010100111011000000101001110000111100100110001100011000110100000110110101100010011010000
11101011000000010010000001101100100111100001000001001000000011001001000000101010000001110000001011000
11000000000010000010001010100110100100000100000011001101100000000000000000010010110000100011000000000
11011111111111001101011100011000000110001000001000100000011100000110001000000100100000010000011010000
10000001010010001000001000100000000001101000000000100101001111010100000000000000100100000111100010001
10000000011000111100000000000000010000001000000000001011110100000000100100000000101111001101110001000
01010000001001011000000000010100000110100000000100111001100101100000000000000010000100100001000000000
00100100110100010010110100100010000001000000100100001000100010001000100101000111100001011111110010000
10001011010000000111010100000000010101100110000000001001000000101100000011000111001110001110100100000
00000000000111000111011110010100000001000001101000100100110001000000011000110001100011100010101100010
00110001100000000010010001110000000011000000110000100000011010000010001010010001001100001010101010100
10110110101011010000010001011111000100010001110010010001000000101100100000000100000011011010000011010
11111110001111111111000000010100001001001100110001100100000000000101000001010110110001010111010111001
11100100011111100000100100000110001001111110110000000001111001000011110110101001001100010011000010010
11001000000010000000000010000010000000000001001010101011000100010101000000000000101110001000101100000
00001100001001101000100101000011100001010101000000000001001110000000110110001100100010100001010010100
00001011001000100101110000000011010000010100000101010000000110010000000000000010001010100110000010101
10000000001000001000111101000000010101000100011101000001011000000000001001010000100100010000100001000
11011100010000110010000100000000010010000000111100000000100110010101111110000010101000101001000000100
10010000010001100100010101000000100000000000111000100000010000001000011000001000101000101001100100100
00100100100100010010110010000010100110101101111010100001000010001010100001000011001100000001111000001
01100000110100000001011000000011101110110111100101011000001000000000000001001000001001101101111110000
01001110000011010001001000101010010101100001000100011010100110000000011001000100100001101100111111010
00000100010001010000011110001110000000110000001100001100001001100100110010000001000001111011011111111
10011001100001100001011000101000001100000010000000000010010000000000001000000010011101001010000110111
00000000000001011011001000100000010000000001100011011111000000001000000001100001011110100000010010011
01000011001100001000000011110000001000000101111010001110001100000000100000010000010100110001001110001
01000010111000010010100000110100011010010000010000000010101111001000001000010100000000000000100100001
10000100111101011000011000010010011001110000101111010000000110000001100001000010000001111101110101000
00101000111100000000001010110111100010100000000001001100011110000000110001111011100100100000001000000
10111100111111011000000001011111010000000001001100100000001100000000000010010000110000001011001010000
00001000111111001001101100000101010100000001000000100100001001000010000110111010110000100110000100101
10000001000111111001010010100100001100001001100000010000001100100000100110010000110010101110100000000
10010100000011101100001000000010000000010010000001000100001001111100010110110000000000101100101010110
00110011101000100000101101110110000011000010000001001000000111110100100000001000110000100000000000001
01000000100010010000010000001000000100100100001000001000000011100001010010111000110101000000001100011
00000101110010010000000000000001010100000000010101110101000000100101000001111000000000011001100001000
11001111110111010100000010010000000100000100000000000111001011000110001010111001111110000000000001011
00001001110000001100100001101000000011011001001000100100110010111110000010000000000010001000011001000
00001000010010000001000000001001000100000010010000100010001100111100100101000001000111001010000001101
00000000000010011000100100000000000000000000000110001001011000010010010000100001100010111100000000000
00010000000000000000000110000110000000001010111100110000001100100000100001110100001000111111000101111
01001100010010101110000000000000010100000000001000010001000010000000000000100000111100011111000000111
10010001111110111111000000101000011100010010100011000100111000100100110000010010110000001110000001111
