11000000001011110000111101000000000101000001110010001111001100001000000100010010100000101110000100001
11100000100011111000010000001000000100110100000111011010000000100000000001000010011101001111000100000
11101000010111110100000110100000010001010011000010010000001100111110010100000011001001000011011000000
10000101000001010010000000000101001101011100010000100000000001001000011110000000001000000000010000010
11001100110010010000000010000001000000000000001000100000000101001000000101000001010100000010000100010
11111110111101000000001000001001010011000000011000010000110001100000000000011010000000010010100001000
11101110000000010010100000000001000111100010100001001000111010000000000000010000101100110100001000000
10001110010000100000011100000000111011000000000000110100110000101000000000000100000010000100010000000
11011001000101100101000000110000000001000100011000000011010000110000001011001000101100000101000100000
00000010000000000010000000010001100000010011101110110010000001000000100000010000000101010000000101100
00000100101110101000010101110000110000000010100100000000010010010000001001000000101000011000000010000
11000100110100100001011011101000001000011000001001000000101101001011000101111000000010000001001000000
11001000010001110000101011101001010101000000001010100001100000100001100011000010000000000000000000110
11000101100111000100001001000010000000010100000000000001100000010100100011101000001001100101000100100
11010010000100011101100100001010010010010110100000010110001100000010011000000100000000001000000010010
11000000001100000100000000011000100011000100011000000100001000000010001100001110100101000001000000000
00000010001000001000100100001110010000000110010000000100100010101000100111010110001001001011000001100
00011010100111001000000010000100000110110000000100010010101010000000000000010111000010000001001000000
00000000001101100000000010010001010001010000000100000001010111111111000000100010001010000000000000000
00101000001001000001000101001111010100010001011000100001000000010011000010001000011100001100100000000
01110000000010001000001000000110110010010010000011101100001010110010101100111100101010001000010001010
11100100001100101001000000000000010110110100000100000001000101000000010001100011000010000001111000000
10001111010000000101011000101001001001100000011000100110000000001000011111010000100010010000101000000
11001001001100000000010000000000100011001000001000001000000000000001000000001000001001000000000100000
11100000101110100101000110000110000000110000100100000000100001000011100101000001001111010010010000010
10000101001110001100000000011100001100000110101001011000000010000000011000111001001100000000001100010
00100100110000001110100100001000100001000000011100000000010010100010000010001000010000100000101100010
01100000000110001110111000001000010000111000010100101110010100010001000011000100100000001000100001000
11100100001010000010010000010000000000011000000100111001001000011000100001100000001000110110000010010
11000001000000100000001000110000101101111110001111010011101000110100110000000010001010100000000000100
10010010101000110100000101000001000000111001000100011000000010010001010000000100000010000000010000100
00001100000011000000100010000000110000100001011001001000000100111000010101001000000010111000000000000
00000000001100011110001000100000000010110000000000000111010100010000000101000111101001111010001010101
00001100011100001111101000001010000110000001011000110100101001100001100100001010011011111110000010011
10011000001001000000000010000001010000000000000001111101000100010011000010100000001001011000000000001
00111001010000001101001110010100000111000110100001110000010000100100000110100111100010011010010111111
11110110100000010000101000110000000000101011001001100000000100001000001000000111100000011010010111111
11110000100100001100111010100111100000000010011000000000010000101001001000000010101110010001000011111
11110001100000001100000000100010010000010001011000000000111000000010011100010000100000001000110011111
11100110010000101111000011101100100001001000010000100001010001000010110100000010000010100000000111111
01100000010000110101000111100100010000010000011101000100000110001001110000010010110001000000100100011
00010000001100000000000111110100001110010110010100001100000100101011101110100000110101010101000010010
00000000000110001001000000001000101010101000000000011000110100000010000010011000001010000010001001000
00000011101010001000000000101000100010000000000100000001100001001011000111001000010000100110110000010
01110000011011101010011000001001001000000001010100010100010000010001100100110111010100001100101101000
00011100000001111000111101000100000100111100000000001000100011010000100010010100000110010010001000110
01011000000100010110001100010110001000010000010000100111100001000100101011000000010010000010010001111
00001000000100000000101100110000100000100011100011011110100100010111111000001001010000000100000001111
00000000010000100000000100110100100110100000100001001100010001000000100001011001001001100100000001110
01010100000110001000000001000011000010010100110001001000001101001100100000000111110010101000001110100
11101000000110011001000011101001000000010000000010010010101001000101100000110001000000010100011000100
00101001000010100100010010011000000010010101100010001000000100100000000011000000011011000001110001010
00001000001001000101010110000010010101001000000010000000000100100001000110000000000000011000101000010
01000110011001000000001000000000010000001110000000110010000011000000100000000111100001111100100010010
00001101101000000100000000001001001101100110001001111101010011010001111010100101011001111110000000000
01100000000000000000101000000010010001101000101000101000100001100001000001010000010011111100000100000
00000000010100000000000011000011000000010100100000001010000000011000000001000010011111111110000010100
11010100000001101000110111101011000000000000000101110010000000100010110000000010010010110100010110000
00000000011100100000110111110000010010000000000010001100101000000000000010001011001000100011010001001
00100000110100001010010110100000001011100000101000101011101000011110100110000000000000000001010100000
10110100110000000010010110000101000111000101010100000010000010100000001000000001000111000000000110010
10000000000011000000101111001001100100011001000100000001001110001000011000001010111001000001000010000
00001010110000001010000010000001110110110001000110000011101101011001001101011000000010000010010111000
00010000010011001000011110000010000001010000100110010001110000111110000001010010100100000000001110000
01000110001000010010111111100000010100000100000111000011111000101000000100000001001110000100001110101
00000100110000000000010000000000000101000100101111000001111011000001110100000000100000001111100101110
10010001000110010000110010000010100011000000010110011111110010010001000000001100000001001000011100100
00001000010101010100010100000100010111010010100001101000111000100000000011001101001100000000100000010
00110000010000111000001000100000001011001001110110000010001000010000000110000100111100011001100100100
10000000000000010010100010010101011000000100100000010000000001000010000111110000001010001000010000010
00010000101100010000011000011001011000100101000111000000001100000000000010100000000001011100000110100
00011010110001000001101110100000001101100000000100110110100010000101101100000001001000001000000101000
00000010101000000011100010000010000001100101000010001100101000100000101110110000110011010000001001000
00000100100011000111000010010000111000100011100000011000001000000001100010000101011001010100000001000
10001100101000010001101000111000000011100001000000110000000000100000000000011001010000000100011000011
11001000010100000100000011111100100001001000000110101100000000011000001000010010000011001100101100000
11000101010000000011100011100100011110000001101000000100100001000100101011010010001001010000001100011
10010010100010000000001101001001010011000111000010100000000010000000000000011010010010001000000010111
10010000101001010001000100000111000001001101011001000010110001000000000000000011000000000000001001101
01000110000000000010100000001000000000011001001000000000100111110000000100000100001000010001101000000
00001100000000110000000000000011000011101000100101001000010000000000001100100000000110010000100101001
10000110010111110011011111010000100100001010010100000000100000110011000000001100100101001000011100110
00000011100111111111000000110100100001000000010001001001110100101010000000001100100101000100001000000
11010010000011111110001100000011000000101111001110010000100000001101001000001000010000110000000110001
10100000000101111000000111000001100000000011100000011000000001000001010100000001001010110101010010000
00000000010000001110011111100001101000000000000000000001000010001001010100101000000011000011111000000
10010010101001100000000010001001001100000011100000000110000100010000100101010001001010101111100010100
00000110000001000100010100010000011110001000110100000000110100000001001000000011011100010111101100110
10010101010010000010010000100101000100010011000101001110001010100011101000011100111110100111010001001
01011100101010000000100011000000100010111001011100000100011010001010000010000001001010010001000010001
00000000100111001000001001000010010000011000000110000000110000001000001000001100000010000101001001001
00110111000001000000101000101000111100000000010101000000110000000000011100011010100100000110100101011
11111000101101001000000000010101111110101000001000011010000000000010001110001011000001010110001100001
11111101000000010010110000000010010011000101100111100010100001000000001010100001001101000000001111011
11111100000110111000001000100001000011010000000110100000100000000000010010000010001001000001101111011
11111111010100001110001110010000000110100001001010001001101001001000110110100010110100001010000100000
11111110000010010000001000000010100000010000001000101100100000001000100010000000000001000110111010000
11111111100000000000011001100000011000000000000010000101010000000000111010100100000011111110101000010
11111111000011010000110000000100000000110110010010100010000010010001111000001000110001111111000011100
11111111100110111100010000010110000000001110011101001110010000000011111100000111000001111111000000001
11111111100010000001000000111111100110100000000001001110000010101111111100000011100001111111110010111
