11111100001000000100000100000000001100000011011000000010010000111111100000001100000100000001001000111
11111110100011010110000011000011111000110111000010001111000010111111101111001001000001110110010000001
11111111111100000000000100101101100011100001110100000000100000111111001000101011101000100001010001001
11111111111111011000000000000000000000010010000000000000000100001100101000010010000110000101010000000
11111110111111100000000000000000001001011000011001010010100111000100101100000111010001000010010100110
11110000111111100011010001111100010110000000100110010001000111001110101000001111010001000011000000010
10000000011111110000010010000000110000100000001000000001101010001110001000011110011010100010110000000
00000001011111100000001000001001100100000110101001001100101000001100000001011111011000000000110000100
00000001000100100010111100100001000000000010001000010100000000100000100111111111111101000000001100010
00000100000000000001110000000000000001001100000101010000000110100001010001100001101100100001000000001
00100011110001010100011000000101110011100100100100111011000110010000001111110000100001001011000000101
00001000111100001100000011101000111111100000000000000001000001001000000001110001111000000010000111000
00000000011111111110000010001100010011100101101100010111101000100000010001110000010010101011000001010
00000101000010001001000101010000111001000100010010000001001110101000000000100000001111100111010111110
00000001010100000001000100010010100000000010000000100001100000100101110001000000010011000111100000000
11001000000000001100011000100001000101001010110010000011000110010001100000100110000000010011000001000
10100100000001010010011010101000101101100111000010001001011111100110100110100000100000111100000001110
00000010000100100000000001000000011110000011001100010101000011000100001110100100111010010000001101101
10001011010010011000000110000101011100000000001000010000010001000000001000001010001010001010101000001
11010000001000000000100001000010001001000100000000000110110001000100100000010010010010010001111010000
10010010000001100000001000001000000000010110001110110100001010001000000001000111000001010001010000100
00111000100110000000011010000101000110000100011111010010100101001001010100000001001011010000001011011
00010000000111000010100110100001000000010001101110000000100000000100000001011011000100001101000000000
00000000000001101000000000100001000000110100001001110100001010100000000010111001000101010000001011010
00001001011110010010000011000100100100100010000001001100100010100001011010000100010000001110001110000
01000000100000100011010000000001100010000000100001001010000010000101010000000000100010000100011100101
00000000000000000001000100010000011000010000100001000000011010110000100010100110111010011111000000000
00100001001100011000000011110000011011000111100000100100111101000000000000110000000001000110000000000
00111111100011111100000000000000101000001000010001101010011000000101001000000000001100010010010000000
10000001010001110100000001110110000100101000010110100001010100001000001000001100010011010010010000010
00111110000001100101010000011010001100000000000000001101110101000101110000100100100000000100000101110
00010010011010010001111000110000000011001010010110001100100001001100000010001000000101000000011000100
00000000000000111000011111110100100010100000000001011000010000010000000001000000101001000111000011110
00000000010100100001010011001100010000000000000011001000000010111000101100010000100101100001111011110
01001100010110001101101000010001111000011000001000000000000001010110001001011110110000101100100000110
11001000000100000000100001000001110100010010100001001010010001000011001100100010000000000000000000001
00000000101101001000001000000001110100110001000110000010100001100000000000000000011000000101000000000
10001000100010000000000000110001110001000000000010101000010011000000000000011000001100011000100001010
10001000010100110000010011000101110000100010000000000010110000101101010001001001010001000000010101010
10000000010000100000001001000010000101110011000000000010000011000101000110000010010000000011000100011
11000000111101011110000100000101100010100001100010001010000111000000000100100010110000100110000001111
11100110010000001000001000100000000000100000000000010000111000011000001000001000000100001001010111111
01110001101000010010010000010000110000000100001010000001101010001101000110100000101111010001000111101
00000100000110000011000010000000111000010100001100000000000001000100000000000011001100000010001111101
10001000001000010000000110101111111010000110000001010000100000000010011000101011001100101100000011100
00001010001011000001000010011000011000011000100001101000101011001000111101100000100001101100010001010
00000001111100001010000000100000000000011100111000000001000001001100011000101001000101111001001001000
01100010000100000000000100010011110000011010111001101001000010110010000000010011100001101100000010000
11110100101100001100000101010100010110000010001101000000110010000001011010000111110000001001000000011
11110000000011010001000000001011000000010010000010100010000100001101111000100011010001000001000000000
11111111010010010010010111000010000001101100000000000000110000010011110010000100010100000000000000011
11111010000100000100000010010110000100000000000111001010001000100001111001011001001001001000010000111
11110000100000101000010110010100100110100000100110000000110010000000010000000000101110000010110101010
01000001000000101000011000100000100000001001110001010010000101001000000010100000000111100001100001000
01010000000010001010011000111010100011000011100100000000000000000000000001101010100111000111001010000
00000110000001110100000000101110000100010100000000010000000100000100011001010110111111100001000000110
01000100000000100000000001100000001101000000000000100010011000000110000000000010011101000000010010011
00001000001000010010001100000100100010000010000100001000110001011000100010000000000100000011000100011
00100001101101000010010000011100010100000111100001100001100000111001000100110011000000110000010010011
10010101000010100100011000001100001100000110000111000100010101010001010000010100011010001000011000001
00000001101000001001100000010010111111010010011010000010111110001000101100010011000111101001001010010
00001010011100000100101000000000010000111000000000010001111100001000100000001010101010011101001001000
01100000111000000001000111101001001001010000000001100100011001011000110000111100100010101001010000001
01101001011000010001000011111101100000000000000001000000000000111000100100100000000000000001000010011
10001110001110000100000111111110011010000000000100110100110110010010100010000011011001101000011000111
01000100000001100001000110011101000100000001000100001010001010001100101001000000001010000000000000000
00011000000000010001000011001100010001101100100000101000010000010100000000000000101011100010011100001
01000000000101010000100010000010010010000101000000111011001001000011000000000110010010000000100000011
10010110000001100100000001010100000100000000000000110010100101000000110000000100001000001001110001100
00111000001001000001010000000011010111100001000100100000111110100000000110000100000100101000110100000
00001111101100000000000000010101000001100010000111000000010010001000010000100011001001110001000000100
00001100011001001100101000100000000000110000010011000001000010000101010000101001010101010000010001110
00010000001111001001110101001001110100010000000001100010010000101100111000000010000011000001001000100
00000100011101100000000010001010010001000100000100100100011100011000100011010000000000000000101101010
00010000001000100000100001010010000011011110000100000000100000100000110000110001000001110000010000000
01001101000011000010000100010001000000000100000010100100000001100010001000000110000111100001000001000
00100000100100000000101100000000011100000001011000100100011011100100111000100101001111111101000011110
10001000010010001101100011001100001001100100001010100010010010001000001001001000100111000100001001100
10100000011110000011001000010000000000000010010011110001001000000000001000011110010010010001100000001
00010000000000100101000000010000000010011110011011100000000000010110010001001100011000001000000000001
01111100000010001000000011111000010101010000111111110111001010000011100001000000110001000000111001011
00000001000000000100000111111000010001011000111111110010000000101110111001110010000000101100001100101
11000100000001010100010100111000101100010000001111110100000100010000000000110001101010000000101011001
00110110000100011110000000101000001110001100011110001001111001001101100110000100111001011000010000000
00001100000100010110101001000001100100110000001110100000100000100010010010000011110010000010101001000
00100000010100110001000000011000000000001000001111110010101101010100001110110000110000010000000010000
10000011001101000011111101100000100100011000001111101110111100000010010100000010001101010100000100001
00100010001000000011000000010100001101010010000000101110001000000100010001001000010110010011011000000
01010101000110001000000011000010001000100010100000100100000000011001000001000000000101000111101010101
10001000100000010000000000000001000000100101000000000001010101001010001010000001000000010001000000100
10010100011010000000010111100000110010110100011001001000111111001100001001100000000001000101000000010
10000100001000000100001111000101111000001010111011010001011001100110001000001100000011101010000011000
00110000000000110011001110000010010010100001000001111000000001010100000101000100100000100000011000110
00000001110011100001000111101001000000000100010110011010100010001000010101000011010000000001011110000
10010010011111110110001110010010000001100000010000100000000010001000000001100000000010101011001011001
00000000000101100000100100111000001100010000010000010010000001101101111000010001010010000000101000000
10100110001000000000001000110010100001010100100010001010001100000100000000101001000100000000010001011
00011000001010000111000100101001000101010000000110000000101010000101101000000001010010000001000001111
00001010000001100111010010000100001100000101001100000000001000000000000000010011100110010010001000101
01101010000101111111100011001010000100100000000111001001000010001000101100100101000100000100001000000
00001010010011111111000000000000011100000001100100001011101110000010011111100000010000101000000000001
