00110000000000000001000000010100111110000011011111110001010111011100001111001001111001010010000000100
10100110000010000101011001000001011100000001001111101010010000000100011110001001111000001000000110010
00010001111101000000000010000011001100000000100001000000010000101110011111010001111100001000001000100
00000010001000010001010010011100001000000000010001010100011001011101001001001100001101100011000000000
10010100000000100100001000000000000100010000000000000010000000000100001001000100000000101001000010000
11100010100100000000011110000000010010010000100000001110000000001010000001000001010001010001101001100
11100000000000000110000000010110100000010100110000001111100010000010001011001110000011001010011010001
11101001000011000010000011100100011001111000101110000111001001011000100010100100010100011010000011001
11101010001000000000100000011001011011001000001001000000001000010001111000011110000111000001110011000
11100001100010001100000100111000100000000000001010000000000011000000010100000111001000011010010100000
10011010010000011110101010011000010011101000100001000000000000100001000010000110011100100101000001110
01001100100010000010000010000000001000000000000001010100011001000101110101100000111000110000010001000
00000001001000000011010010000100101000000000000100101110000011100101010100110001010011000000100011100
10101000000110000010000000011000001010000000110101100000000011111010000010001100000011010000000001000
11000100101111000001100010010001000000000000100111110100010011100011000011100011001100100000000100111
10000100000011000011000000111100000001000000011111111000000110101100000010000000011000001100110100100
11111001000100000000100000010000100000101001101110010001010010100011000111111101001101001001100100101
00100000001100000001011011011010010100001001000000001010000010000011010111100000000101000000011001000
01100000110100000000001110010010000001111000000001100001100000101101011010010100111111110101000111100
00010100000011101010000000000000000000010001110101101001100000010001101001000011111100000100000000000
00001110100000010111110000000110011010100000000000111010100000010111000010010000111000010001001000100
00000001000000010010000010001110100000100000001100000000101100100000001000011011111011000110100000101
01100100010000001001000000101101100001100101110000010001000100000001001010100001111010000010000011000
00001100001010010000110010000000010000001001100111000000001001010000001110000001111000000010000000111
01010010000000001100000000010101000111000010001110001100001100110001000000110111110001100000111000001
10000110010001000110111001101100011000010000100101001110110001000000000010100011011100100001001000110
00000000110101100001111100000001000110100000000000100100100001000000011000000001000100100000101001000
00100010000100110011111100100000100110110000000001010001100000111000000000101010000000000110000010010
11001000000000000011011000010000000011100000000000000001001010010000010110101000000001000010000001100
00000000101110000101000000000100001111101100000000000000101010111001100001000000000110001010011001000
00010001000001110001110010010100101000011000001110100101000010010100000011000001000101110000100000100
10000000001000000000000001000111001010010111111111001101100000110011001000000000000001011010111000100
01110011000000010100000000100010000011000000101000000000111000000000000110110100100101001000000001001
00000100000001001010100101010000000001110000001001110001011000101111100011110010001111100000000011100
00100000110001001001100000000100000001000000101101000000010000110110000101000000100000000000000001000
00001110000000000010000001100110000010000000110110000110100000010111000000101011010000001001001000000
00010000000010001000000100000011010010000011000010000110010010100010110000001110000000000110011100001
10110000111111100000001000000001000001000001000010000000010010000000111100000010000010001110000010000
00000011011111100010001000000100000000100101010001100000000000100000101011000010000100010110010010001
00001010000001110010000001100101001000110000100000101010010001111001001000110110010110000001000000100
01101010001001100010010010001101100001100110110001000010000011000000001000000001000010010010011000100
00000111000111000000001000110000000000000001100000000001000000000010100000000001000000100110000101100
00101001000101001001000011000000111111010110001000010111101110100010001101011100001000100000110111110
10100010011000000000100011100000010000101101000010000000110010000000000000001001100100010100001011111
00100000100001101000001000001000100100100000000010011100010010001001110001000001110001000001011001111
11101000010000101000010001011000000011100010000010010000100000000011110011010011110100001001100001111
00001001100000001000010110000010100100100111101010110111100000000010110110111001110110000000000100111
11011010000010110011001101011000110010000100000001000111101000001000000000000111111001010011000001111
00110010100000110001111001001000000000001001111101101011110011001000010110010000100001011110000100111
00000011101100001001001000111000000001000000000111101000110001000011000010000000000101011100111010011
11010011000000011100000100100001100000000101000010010000110001000010000000011010100000100010011001111
01001000110010101010001100000010010000010001001100010000011111000000001100111000100100000010100000011
00110000000000100011001110001000010001100100010000000111010000000011100110111110100000110000000001011
00010000110001111000111111000000110000010101010010011000100000000011000011111100100001110000000000011
00000001000101000010011110001110100010010010000000100000000100001010001000011000001100111110000001011
00100101100011000110011111011001000010011100001011000000010000011110101101010000000000110000000010000
00101110001001010000000011101101000001000000000010001101000000010010010001100100011001110101000010001
00111100000100011001000000001000000110001100010000100001100101000001101000010000010101100100000000111
01011000001000000001001001011000001000010000011101100000101111100100000010000001110000100000000001111
00000000001000001000101010000000011100110001000010001000100001101101000000011000100100000000010101111
10100001000110000001101011000000000100100101010011100100100011000001000001110010000110100001100001111
00000010101111000100000000001010000000010011010000111101101010100010011000000000000001111100110010111
01000100100110000001000001010000000101001000000000100001101000010000100010010001000000100000100110111
01010010010110000111000101011001001100010010011000010000001000001000100000110111000011100010000000111
00000000000000000100110000010001001101011100000001001100010000010101000110011001000000100011001011011
10101001010010000110001001111100000010000000000000000011011110100000000110000010000100010000010011011
10000101000001110000000001001000010000000111100101000000100000000001000001000000000100000001010101011
00001100000000000110101011010010001000110110000000100001000011000101100101010110100000001101000101001
10000000000100000000000110010010001000010011100001111100110001001000000101000010100000001000001100011
11000010010100100010000010001000011110000100010000111110000000001001100000000001011000010010111001001
00001111011011010011001000000001000110000110100001011110000110000011100000001010001000010100100000010
10010000110010000001101000000011101001001000000111001100100111011001000000010001001110010000100111000
00001010001001011110100010000010101000110010011110010001011110010001100101001100001100000100000000010
01010110010000001000000010100110100000011000001100010000010000000001110001000001100100001000100100110
10010110000000110000000010010110000011100000100001010000010101001010100011010100010100001000100010110
11000000000100001000000111101000011010001000000001010001000001100100100010001101011000000010010000000
00001000000110001001010110000010000011010110110011000100100010000110000100000110011110101000000000011
10001001000011110000000000101001010001000110111000000001100000000001100100000100101010001010000101011
00100010001000000100000101111100000000101010011000001011101100000010000010001001001000101111000011001
00100011001100100000010111101011000101100011000010000000000011100100011000001000010000100100000101101
01010000100000011000010111001000011010000001000000001000000000101001010011000000100100100001000001001
00000010011110000100000000000000000010100000010000000001000000101110000001001000001000100001000100101
11000000000000110000100000000000000000000000011101011000000110001101010000001011011100010100010001001
10000010000010010100000111000000000010010010001000000000001011001001101111010000001000000001001001000
00100000100100000010001000101100000000000010101010000000011000101100100000000100100001000100001000001
10000000010000100000100001110010000100101011110010000010100101000100000000000000000001010000000001010
01001000001000101100000110110000110000101000111000011111000001000101010001010001000010000010011100010
00000000101000011011010000010001100101000000000011000110011001100000000010100101000011001000110000100
00000001001000000000001001000111000001001001011000110000011110001000000000010011000000001010100000101
00000001001101000010000100110011100000011010010011100000101100001000000110011000000001101111000000000
11100101000001000000000001100000000100111100101000001000000000101110000000000000000000000000001110001
00111101000000000011010000110100100000010000000001001101010000000100100000000001010110000010101111000
01110000010001100001001000100001111110000000000011100000101000000011001000010000100100100001100111010
01100001001011101000010000000001111101010100001011000001001000100010100100000100001100010011110100000
00011011000110000011010011000001111100000011011010000010010010001010000010000000000110010001000101110
10010000100110010000000100001010111100000000110010000100011001000011010001001100000000100000100000100
00001100000100000010100110000000011001000100101011100100110000110011000100000000001001111100000000001
10101001100001001100100100000010111000000000000110110101010001000010000110000000100101100000111000000
00011001001000010000000100100001110010000000000100000101000000100001000010011010000110000000010010100
01000010000110011000000000100011101000000000001001000100101100000000000010000110101111101001001001000
11110010000111000010001100001111100000101001111000000100000011010111100001100001001111100000110000001
