11111110001110001010010011100001000100010100010010000000010000100000000000000000000011110011100000000
11111100100111100010100111110001000011000000000111011000001110000000100000000010000011100000010000000
01111010001000001110000011010011000000000001000110000001000011011100001100000010000001000001111001011
01001000000010000110000100000011100010010001011110001011001000000000110111011111000011100000010100100
00000010000010001000011000000001000011100000101001000000010000010101110111111111010001011001000000001
00001000000010000010011000110000010111100001000010000100111001110000010111111110000011000000001010000
00000100010000100010110000010000000010110000100000000100010011000010000111111000001111001000000010110
01000000001000000011000110000000101100100011000100100000010100011111000010110011000010001010001101111
10000100000000000101000010000100000000010000001101111001001000110000000100000110010011010001001000111
00000010000100001000001011100000100100010000000010001010001000100001000000011110001100010000110001100
00011100000001010010001000010010001100000000000101000001111100001100010010000110010000010000000000000
00000001010000001011000011000110000001000010000000100000011111000000110110000001100000001110000010010
00010100101000000010000001000011101010001000000000000011101100000000100110000001000001000000000000000
00001000000010101001010001001010100000010010100011000111100001101001010010000110001000100010000001000
01111001000000111001000011101010000000101110001000010110000001111110010010000010100010100000000100110
10010010100010001111000111101000001100001010101000110110000100000100010111000000100010010100000001111
10000000001010011100101111100010000010100000010010000111101100001110010110010100000000001000001000111
00010011101001001000011101000011001111001000001000110111000100100100110010001010001000100100011010111
01000011100110110000111000000010010000000000000000000100011011000101100011000010000000001000110001010
00011111000100000110110010000001000001010010100101001110000000000000101100000010000001000000001000000
00000011100000100000111010110100001011000100000000000100000010001000000101111000000001111010010000000
01000100000110011011110010100100010001101110001000111001001000000000110111011000000001001010000000011
01110001001100000000111010000100001000000000110000010000001001101111100000001000100000000000000100001
00001000000011100101000110010001000001001110100000010110101001000010000000101001100000110001110011011
00000000110000011011101111000000000100111000000001110010001000000010000100000000000001111000010001011
10000000000000011001000100000101100001100100001000100010010001000100100000010000000110000000001001001
00100000001100101011001001000000011000000001010000010011100111100101111110010000001000100110000110100
01100100110111001001000010001100001000000100011000001110100000000000110011101000000010010000000110010
01110011000001000000100100000001011101001000000000001000000000001000001000100000001000110100010010001
10100010000010000000000000100101001000101010000100110000010000111100000001100010001100100000000010110
00001010100000000000110010011110001000100110101100000000000010001101000110010001100000001000011000000
00001011110000010011000000111001101010000000100010000000000001000000010100000000001001000001001000111
11001000000101000011100001000000000010101011001000000010000000110000000001001100011100100001011010010
11010101011110001000110011101001001100000111100000000011000000010000011010000000001000100001001000000
11000011010000110000000000000010000000001111100100000100000100001001100001000110000010101000010101011
00000110001110100000010000101000000010101101010010000010010100010001100001010010000010110000000000100
01000110000001110100010000101111000011110000010101010010101111000100000100000111010101000011010111000
00011000101011000000001010001101111010110010011000111000101111010000100000001111001100000100000010011
00000100110000000110000000000000101000011000000000010000001111111011000101001110011100101000100110001
00011100000111000001000101011000000010110101010010001000000101011100110001000110000010001011000000011
01000000011000001010110010001000000110000010010100011100100000001000001111010000011100000100000001000
10110001001000010110010000100000010110110010010011001110000001000000100000111000011000000000010100011
10000001000011110000000110111001011000000010000111100100001001101000100000010000110110100000001110001
10100001000010000101000001011001000000101000001001001100000101100101000010100000000100100100000000001
11100000101011001000011000001011101100101011000101101010011100110011100000000001010000001001010001000
00010100110010001000001000111110001000000001000000001010010000010011110000000000110111000110111101100
00000010111101010000000010101000100010001100000100000010000000010001111101100100001100000010000101000
00100001000000111101110000100001101010011001000010000000000100110000110000101100000000001000000011000
00101001000010011000011000011100010001000000101010000001100000000101110001101101100101000001000010100
01000101100001000010100001111000110010001001101000000000001010001100100101010011100001010101000100100
11100010101110010000001000000010011011000001000000000000000010000100000000000100010101000000100010000
11110000001100010000100110110000001001000010000000101100000111000010001000000110101010000011111010010
11111110000000001000000100000100010010001000000101001001010010000001000000000000001001010011111100010
11110000000101100000110001000000000011001000000010000100000000010000000100001000000100100101111100011
11100000000010011111111010000011011000011001001010010001000100111000001000000100000000010000111000100
10000000001100001000110000001001111010011000010011001001101110001000001000101000010001100010100100110
00000000001000100010000010001100010100001100111000110000101110010100111000000000111001000001000111000
00101010110010111001001001111010000010100001000000000010000000010001101000110000010000000000100000011
00001011000011001001000010000000010000010111111010011001010101001100000110100001011000101100000010111
10101001101001010100000001000110001000001001000001100000110000000001000010000110000101011101001000011
00100010000100000001001100110100001101000001001100000001010001000000000000010010000000000010000001111
00110000001000010000000001001101010100001000100110101100010101010110011000011001000101110011101001111
11100110000000110001100000000000100110100000111110000001000001001000011001010011110001010000100001111
11110011000000010100100110100100101001000000111111011000010010100000001010001011000000001000011011111
11110011000000001110100000010000000000010001111110000100010010100000000001010000011001000000101101111
11101000000000000101001101000001010000110000010001000110000110111000000000111000001000010111100001111
10000100000110000000100100100000101000011000110100001110000000110010010100010001100001001001100011111
00101100011000001101001010100000100000001000001000011111101100000101000010010011100001001101100111111
00010000001000010000100010000000000000110001010000000111101101000100000110100101100000000100000111111
00000001011100000100000000101101000101100000000000000010010000111110000001110001100100000100000011111
00110001100000000000000110010100100011000000001000000000101001111101010111100100010000000100000000011
00100010100000001101100001100000010100101101000010101001000000111100001000000010010001110000110001111
00000000010110010111110011100010001010000001000100111001000110000000000000100110000100010000001011010
00001000000010100011110000010010000011111001100101000100000100001001100001000010110001001001000000000
00010010000001101001110000000100000011000100000101001000001001110000010110010001001000000110001010110
10011111001000110000110010000110011001100100001000000010001100000001110100100010001001000011000000001
11000010000001111000111001000000000000100001110010010001001100010100000000100100000000001001010110100
10001110000010010001110011101101000000000100110000000000000000011100000111000100100011000000001000010
00001000110010000111010010000000000101000010001000010011101001110001100001001011001100010001110110000
00000000010010000100001000110010100000000011000000001000011000000000000100100010000111000000000000010
10000000100110000110001101101010000100000000010010110000111100010011000010101010000000001110010100011
01110110100000100000000101000010010001000000110000111001011110100011000010000100110000001101100010110
00010000010000010001010000000000000010011000110100001000001100000011010000010100000011000100001001000
00100011001100000011000100010001010111000110100010000000000000000000010001100110000001100100000000011
01100000000000001011010000000010001010001000111000001001000100101010001100110010010011100010001000000
00001000000001000000111000000110101000100000111101110010010010110001001001100000100001011100100001010
11010110011000111000100010010011111000001010111000000011000010010010011000100101111010000000001000010
01010000001001001001000001110010001100100001111001010011000000001100101101000000001000001100101100111
01011010000000000001110010100100010000110000000011000000101000000101000000100001101001000000000010010
00000110000000010010010000110000110000000001010101001010100011000100010100110100010101110001000001000
00001000001000000001010000010000000010001000010000001001100001000100010000100000100000000000000000101
10100000001010101101000001111100010001101110001110100001000100000000001001100000000010000000001000010
10001000000000111001010100101001001011111111010000011010000101001100010001111101000000010100000111000
11010001100000110000001001100000010000111111011100001100011000110000010000100000000100001000110000000
10000000000011000000000000101000000111000011000001100010101010010000011001001000000110000110000100000
00100001010000100000010011100010000001000001000101000111001011000001001000000100100101000100101100001
00010100000000000000000100010100000010001100001000000000000000000000000000110001101000100110100111011
01000100010000001000110000000010000100100000001111010100100001010010100000110001000000001100011001111
00100100000110011110010001001101001110001000100001100010001010011101000001011001110101100000000000011
00101100100010000000001000011100011111000100101001001000100100011100000000001000000000001100010000011
00000000010110001011000110011000001111000100100000000001000001001000010000000110101101010001100010011
