11101000100000100000000001001000000011011110001111000000101000000000010100011011000000010111000110001
11100100000000000101100101000000010000011000101111101110100001000000000000000000101000000010110001000
01100010010001011000001001000010100110010010011111100100001000000100000010011100001010101000000111001
00010110000001111000000001000010010100000010001011000000100100000000000000100010101100011100100000000
00000000001100010000000000000000001000001100100001001000000000001100000001100100000000011001001110111
00000000111000001000010001010000010000000011011000000000011011010111000000000000000100100100101000111
01000000100000001111000110100000110100101000001001011000001001000010010100000000100001000000100010111
10010001001000000110100000000000010110000010000000110010011011000110011001000001000000000100000011111
10100000000010010000100010100010111001000000000101010010001001000001111100000011101010000000000101111
11001000000010111101010100001010000001100100010100001000000000000011011110000101001110100000001100111
00000111101001011001001001010100101110100100001100010000011010001000001010011100010000100000110000011
10101100101001010100000010000000000000010010000000000000000010000100010000010001111100101100111000011
10000001010000010001010000001000000000100001100010010001100000100000110000100000000010001000011000101
11010001000001010111100001000000000000000010011000100001001010000001001100110010110011000001100000000
00001011010010001100001000110010001000011100000000011010000100001000000001000101011100000000000001000
00100000010011001010010010011011001101101100000010000111101100000001000001000000000011001010000010001
00010110000010000000000000000000000011000010000010000011111100011111100110000000010110000100010011000
00000100100010010100000110000001001010110001010000100001100000100000110010010001000000111100100100000
00011110001001111000000010010000011010010000011100000001000000100010000011000100010001000000000011100
10000000100011000000100000111001001011000010111000100011101001001010000111001000011000101000011000010
00000000000010001010000010000001001010000110100000010000001010000000000001101000000011111100100000110
01010001000011010000100100001000000001010010110000001011100010001110000000100001001010011001110000100
01110100010011010100000100010000010100100011001001101001101001011001000000010101011000000001111100001
00000100010000111100010010000100000101011001000000001011100010000000001000100101000100000100010100100
10000000100110000000010011010011000000000000000001001001110010010101010001111110000001000000000000000
00100001011001000001111110001010010010110000010100001011001000000110100000101001000000101001000011011
10101100000000000010001001000010100010000001001010101010000000010000000001000010001111110010100100000
11110010000010011000000001010100100100000011001010010011100011010000000010000000101010100010000010000
01101010111000111000000011000100000011000000000000110001010010000000110000000101100000000100000010100
01000000001011000001011101010000000000000100000100100100010000000101100000000100110000000000001100100
00100000101010111110000100001100011000111100000111000101000100100110110001000100100110000001101001000
10100100010000011111000100110000010000010100000001100001000000000010100011110010001000000101110000000
10101000100000011111100100000000010101010010010110110100010101000000010101001100000000000000101010000
00100000000101001110101101000010001100000000001100000101010010000110101000100110000010000011000110110
00001000101110010100001010100010101001000010101001001010101010011010100000000001100001001000001001000
01000000010010010011100000000011000101000110110010010000100000010000101000110110000010010001110000000
11000001000111000001000000100101000101001000000100000101010011000000011010000001010000010000010000000
10000000100011100010000000001000100101100010010001111000000100001010011110000000100000000010010011000
00100100001000001000001000110010000000001000000011111110000110001010001100101000000110000000000101010
01010000000000011100011000100000001000100011100111111011100010100000000010000100000011111110000000001
10010000000000110000010000000011110000000000000011111010001000100100010000000110000100010101001101000
00000001011001100101101000011001111000010010100000100001000001000011000100010101011001010000000010001
01000001000010000000100001100010011000010110000101000010101010001000010100000000000001000100000000001
00000000010001000000000100010100001001100000101000101010010000000100000010101001000011000110100110000
00001000100010011010000001010001000110100110000000100111011000110011010010000000000000001001000000000
00100010110001001010000000000010001000100000001110001010000000010001001001101000000010000001010010110
10010010001100010000101101000010010010000000000000100010010101101100100000101001000000010101100011010
00001000000110000000101100100000010100000110110110001001100000000010111100010000001000001101010000000
00000000101000110000000010010011000110000000100101000101101100000010000000000000100100000100010111000
01011100000110000101101001001000000011000000011100000001010010100100000000010110101100001000000100000
01000010000000001100000101100110011010011010000011111110010100000000011011001100000000000001101001000
10000010010110011010000000001000000000000001100000011100110000100011000100100101100000011000001000000
00000001011110000010111101000010001011000011001000001000100010000001000000010100001111100100001110000
01000010001110110001010000111011000111110000010101100000000011000100101101010000100001000000000000011
00000010001110101000010001000001000010001000000100011011001001100010011100100000001011100100010100011
01010011000100100011000100001000111010100101000111000100000000100000110011000010000001100010000111111
00100100110101001100000110001111000000111100000100000000001001100000010011000010010011000000010011111
00000000111110000011011011011000010001000000001000000110001100000100000111111000110000100000000000111
00110000111000010000010000010000001000101000101100100010100000111110000001011100011000001000000000011
10011100111000000101001100010110001010010000000000000110100000101100000100000001000000010001000000011
00000010111100000100010000001101110001001001010001010110010000001101001110000100011010011000000101101
00100100011001011010010011100000001000000101000001101100001000010000110111010000001000001000001111000
10100000111100000001100011101011011000000000000000000101100000000110000110110001101001101000000010000
00001110111000010100000001000100011100000000000110000100010110010000101000001010001000010011000000010
00100101000100000000000000000100001001000010100000001001000100110000001000101001011111111100110000001
00000001100011010000100000001100100100110100000000001000011111100100010000100000001000110000010000000
00000101100000101011001100010000000001001110001000011110111110001001000000100011000000010000110100001
00100100001000000000110000000110101000000100011101000010001111100110010100001000000000000000011110001
00001010100000100000000101010010100000000000111110101000000111001100110010010000000000000001001110000
00101000100011000100000010100000011001100000011100000000000001001001111100010111111010010010100110101
10000100011010000100100110101001100111000001101010101100001011001001111100100011000000001000000010100
00000000101010001000001000110010010111100100001000000000000001101100110000000100100100101000010100100
10000010000000001010000100000011000101000000011001100001101100011100111111001000101000111100100110000
00000010000010100000001000000000000000001000001010001110010100111101011111100010000101111100000100001
00001000000100111110011000010110000110000000000010100100110000010110000011100000000110011000110011011
10110000010000011100110100100100001101000001001011000000010000000000000100000110010000010001001011111
00110010000010001101000010000000000000110001000011110010000010100010000100000100100001000111000110011
00000100011100010000001111000110000100000100001010001111000010001010000001010011110000001110101000011
10001100110000000001001001010000101000101000000000001101010100110100010001110100100010000000100001000
01101100011000000100001000100010000000010000000010100000001001110101000010100010001000100100000111100
00001111001100101010000001100000000001010010111000001000000110100111000000100110000100110001100101000
10000000001100010010110001011000001000110010000000100111001100001001000100100100100010101000011001010
00000001011100000100000110001000001101100010001010100101000000111000000010000000000100001011000010000
00110100001000111000101000100000000010000000100110000100000000101110010100000010110110000000100000011
01111111011010100000010000111010011010000000000000010011010010000000100010000010000010010001011001111
00010100011000000101011100011100000000100010000100000100001111011100111100001100001001110011001001000
00100000100010000000000110001000000001100000010100100000010111111000011100010000101000000100100000000
00001010001000000110000110001100000000010000111011001010000001111000001101100110110000001001100000000
00010001010010101000001010010001000100000000000000010000000000100110000000000000101010101100010001000
01100000010110100010100000101100110000101000101100101100000000001000001010000011000000000010001100010
11110011000000101001100000000001110101000000001101100000001000001111011001110000000001110010000110000
10100100110001100000011100000011100000000101100000000000001000000101000000100011000100000000011001001
00000101000000110010101010000110000000001000100010010010001000111100001010000000000010001011001100001
10101100010000010010000001010010101000100010001000010100001000001000000100000011001010100000110000000
00001101001110010000000111000111100000000101110001001000000001001000000000001110010100010100000100101
01110011100000000000100010001011010010000001101011010011010101010100000011011000000011101100000000000
00001000000010101001000001000000001000001101001000000010000000010000100100000010000010000000000010000
11000101000001111001101101000110000010101010011000110111000010001001101101000000000000000010010000101
11101110000000111101001000000011110010001000001100100010001011000010110010000100011001100001000001000
11001001000101111000001100001100000011000110000000000000000000000110000010100110111101100001010101001
11100001101000110000001000111100000000010000001010000101000000010000000000101000111100101101010100000
