11111111100100000010001000100011111101000001000000100010001010000000111000110010000001000001100000001
11111010000001001010100100101111111100010000101101001000001000010001001010000100001000001000000000000
11101000000110000010001000000111111001101010000100111010001010001000011011000100000001000100101000101
11001001010110010000010000001111111000101001000000111100000100000001100000001100001101000000001100000
00000000001001100010001111000111111110001000110000001000101001000010010110010100000000101101000010101
00000010011001100010010001000101001000110001001100111000100100001000000001010000100100011100001010000
00100111010001001000000100011100000100000010001000011001000010000010000000000000100100001010001110001
10010010010000000100100000000011100011110011000101100101011000010010000000100100000100100000000010111
11010100000000100000011010101000010000100010001000110001000000110011010000010011011000010000000000011
11000010010010000110011111110010000001001010010000000110010000001010000000001100101100000010111000001
11000000000000010010000011100100100110001110100000000000101001001101100110001010000010001001111000000
00000000001000110000000001110001100100001000110001000011101001001000000001011001010000000100100101100
10100000010000100010011000100000101000101001110111100000000001011100010100000100001100000000000000010
00110000000000001001110010000011000000010100000100000010000010011000101000001000001010010000100000000
01000001000011000000000000000010100000100101000010000100101011000000000110100110000000001110000001000
10000100000111000010100100001000110101000001010100000110100000001101010010110010110000100111000100000
10000000100010000001010010010000111010001000001000100010101111100001100000000110011100000010111100000
00101010000101001000000001001000001010001000111101111010000001000000000110011000001100111000000100000
10000111110000101000001000000010000010111110101111001000000000000110000110001000000000000001101010101
11000010011000101000100010110010001001000111100100000100000000010001000000000001100010010010000000011
11111100000001000101000000000111011001000110001000000100010000010000000001010011111000000000001000001
00110110000001000001010011001111111001001000100110000001000100000000000000000000111000000000001100000
00000000010110000100000011000010001100000000100010000000000110001000000100000000000000000010101111110
00001001100110000001011010010010000011010010001000000110001000010001000100000110010001101000000000000
10001001010010001000000011000000100000110010111000001000000010010100000010101011000001001010000100101
11100100000100100010110000010100101000001000001110110000000000001000111000010001000101000010010101101
00000011000011010010000100001001000000000001000001111000101010000000010000000100101001000000010000011
01000100000000011010000010001010000111001000000000110000101000101011100100000010100000110011000001111
10011101100000100000000000000010110000110000001000010001000010110011110000010111001000000010000000111
11111111001000000010100000100100111000000010000110100000000100111001111000100001010001000100011001111
11110000000101100011000010000010001000011000000100010000100100101000111101100100100001000100001001111
11111001001000000100010100110100111101000101010000001000000100100001011001011011000010101100000100111
11111100110101000110001100000001111001001111000010001001010000000010001000000001011010011000110010000
11111110010000100010010000010000110011001001010011011101010000001101000101101110010111000000010011000
11111100111011001100000001010010000100011000000000001110000100000000000001000010000000100011000001000
11111100010001000100010000001010011000000000101000001110110001100000000010011001000010000000011000100
11110010110010011010000001001010000000011000100000010000001000001001101010000010100111100000100000010
10001000001010000000011100110010000001001001100110000000010000000011111111001010000011010000010011111
00001001001010011000001101100000010010001010000000101000001000001011111010001110000010001001110000000
10000010000001100000001010000010010010100010000100001000110011000000000001001000100001000000010000000
11111111000010100011000000010100000101101110000010000000000100010000110001100000001000010001000001000
10000100010010111011000001000110010001100010100000110000001000100100010000001001000100010010001100000
00100000010100001100000000100000000000010001000101000010000011101011001000010110001000111000110000011
10101001100111010000000100110110000000010100011001001000010100001011000000000000010010010010010000010
00001100001000010000101000010000000001010001010010000010100101000010100011100010110000000100000101000
01000100000000001100010000010000010001000100111001000010110111100000001000010000100101101110001011100
00101001001101000000100000000100011100100011011100100000010000100010101010000000100000011100001001100
00000011000111000010100000001100000100011000001000000011000011000100100000101000100101100000010011010
01010001001001001010011001000101001100100001000110100010010101001001001010010110010101000010111000001
10000000101011100010011111101101000000000000100000010100011000100010000000110100000110000011000000000
01100000000001000000101100001110011001000010001011011110000100110001100010000000000010000010000001000
01010001000111010010000010101100000000110010010000011101100000100000000010110000101000001010100001001
00000001000011110001000011100000101101000000000110010001001100000011000000001010101000000110100101011
00001100000111110001101110011000101010100000100000110101010010000011110000010101100010010000011000111
01001110000011100000001001010010100000000100000000000011100010001011000000010001010000000001011100111
00000100010010000100010000010100000100000011000101000001001011100100000000000010000100010000001010011
00000100001010000000000100100000100000011110000100110100001000110100000000000011000001000000111000111
10000010101010001100100101000000000000111000001010100011000100000000100000001000000000100100100110011
01001100000001001110100000110011000011110010000001110100001101110110010010000000100000011100000110001
00000010001000000000110000000100001111111010010000100001111101111001000000000110000100000001100010010
10000000101000010010100010001000111111110001110000010000111001111100000001010000001100000001001001000
10001011101100100100111010001100001100100001111000100100110010100010100000100100100001110001011100001
00110000001000011101000001100111011101000111100100010001000100001000010000000001000010000110011100000
00000000010100000100001000000100101000010011110100000000010001000000111001110000100000100010111011000
01100100000010110000000011010110001100100001000101011100000100010000110100000001000000001010000000011
00101010000100010000000000000000111011001110110000001001100000100101000011010100001000001001000000011
00000000100010000010110100100000011000000110001101100000101010101000000000101101001010110010100000011
00001100010001101100000001000111110111000110000000011000100110100001000000100100001010111000011110011
01001000001000101110000000001000000001000001000001100111100000000000000001110000000010100010000000000
10010100100000000001001100001001000001110100001100101010000011001011000000010100000010000100000000001
00000000011000010101000000001100010000000000010000000000010001000011100011011010101000010010010000000
00001001010001001010100000001000111010001100001100011000000000000111110001000000010011100111000010110
00110011100110010010100010111101110011000101001000100000000110110000000011000000000010000010101000101
00011111100000000000000110001110110000001000100010101000001000001000101001010000100101011000000000000
10111111110100000010000001111000000000010000100000000001100100100111000110100111010000000000010001100
11111111100000000110010000000010010010010010001001000101010000000010001100001000010101001001110011100
11111111111011101000001000000010000001000000000110010000000001010010010001000100000101011000110011000
11111111101010001100000100100001000101010101100010000100010001001010100000100101010100001011110100000
11111111101000000001001010000000000010001001101010110001110001001100000000100001011000011100100111100
11111111100001000000100010100001010100111010001100000101110010011110000000000100000000001110011010000
11111110000100010100001111101011000000000111100011000000100000001101000010100000000001110100000000001
11111011000000001000111010000110001100000001100010000000011101010001011010101000000000000000001010100
11100010000000000010000010000010010000000010000100100100111100110000000000000010001000110001000110011
01001011100000011000100110111000000010000000001001001101111100011001110010010111001000100010001001001
00001010101100011100000100110000000001000011100010010111110001000100001000000010001010111111010000010
11010000000011100000000000100101001000110111110000010011000101010011101000100100100001100101000000000
00010001001001110010110010110000010101111111000000100010101110001001000000001001110011100100001011110
00001101100000000000100100001010100000111111000100000000001100000011000000001011110011110000100111110
10101001000011101100000100000100000100111101010001010110000010001100000000011111110100110000010010000
01110000111100101101000000010010010000111000000001000000000011100000111000111111100001100111100100101
00100000010000111110000101000000000011100011001000110000010000100100100010000100000000100001010001000
01001101100000001101011000010000000011001010001000000100110011010001001100001000100101000000000000100
00001110100001000000010000000010001000010001100000010001111000001011100010001011000000000001000000000
01010010001000000100011001010100011100000000111001110001100100100000100001010000100010000000101000001
00000000001010011110110100001100011110001000000010100000010000000000110001111100000000011001100010011
00100001100000111001000001000000001100000000011000100100001010000100010000011000001010000100101100111
00001101000001111100010100001100000110110000000100000000001001001000001000000001101110000010000100111
00001000000011111000010010010000100001100110000010001100000001101000010001001011001001001001110000011
01000000100001011000000110000010000110101101000010001000000100010011111001001100100000001010110000011
11000001111000010011100100100100110110100000100011100100100000000011000011000000000000111000000001001
11000000011101111011100010000001100000101100111010001000001001111110000000010000000100011100000000000
