11111111101000010100000000000001010010000000100001100000100000010001000000100100011111111111100111000
11111100100100010000001001100011000010100101000000100101100001110101100001000000011111111111100111100
11111100100000000110101000100011000000011100000000001000000100010100100101101000111111111100000111000
11111110001111001011101000001000101000010000001100001001000000010100010000100000000100101100000100010
11111100010111001000000001000000010100000010011000000000010000000100000000011110001101100000010000101
11110000000001101000100000011000000001000000000000010001010000110100010101111000010001010000000010000
11100101010001000000000000111100000000000010100000110000000100100000000010110011000001011001000000100
00001011100010111001000000000110101011011010000101000000001001000000000000000000011100000000001000001
00000001000000001000011001001000100000000000100001001111000000110000000010101000111110110011100000010
01000000000001000000000000010000100101000000000000000100110100000000101100000000110101000100101000000
01000101110000001000110111000010100101101011010010010100100000000100000100101010000001000100100001010
00110010100000000111000001000110001000000111001000000000001000100011001100100000101100010010001011010
00001000100000110000010000000111101111010000000100100100001000100000000000000010000000000000000111100
10000011001100100000000010010001000001100001000000000000100101010100001010001010001000000010011110000
00010001010010100000100010100110011100000100101000000011001110000010010011000001000001000001001100110
00010100000000100000000110010100000101010000000000011100000100000101001000000100000011000111000000000
00010001100001111000100010000100101000000011000010100000101001101100010000000101001000000101101011001
00000100000011100000001100100110000000001111000000011011001000100111010010000000011000110000101100111
01100001100100000001000000000010011000000000000000000010001011100000001100110001001000001100010001111
10001001000010000101010111100010001011000000000100000101010010110001000000100011000010101000010101111
10000010010010100010001100001100001000100011110000001101000000000001001100010000000000000000000001111
10100010100001010010000000100110111110000100110001010101010000000001000000000010000001011000110011111
00010000101010001100010011010000001100110100000001100000111000000001110100010001101000000000010111111
00100000100011010000101000000010010000001000000100000101011001000010101111100000101010000110100001111
10001001001000001100000000010010001000000100110001110000000000100010100111011011101011011111110011111
11000010001000001001100001011110010111111000010001110000000110000000010101010000110001010010100001001
00101000001111101011001000011000010000001011010000001000010110000110110000000000010010000110001100010
01011000000010010011000000001001100000000000111000001100110001111111000000100001010000000010000010110
01011011101000110011101011000100110001001000011001000110000101010011000101000000010011111000010110100
01000000011100001100010100010100000101100011001000000000010010000001100001011010000001100001111000100
00000010100010000100010000101100001000000001001000001000010001011000001000000101100000000100110011100
11100000010011000000000000000010010010100011010000011110000000111100100000000000100000000000011010000
00111000000100100000010000001000000001010001100011001000000000010000100011010000010100000010100000110
00010001000001110000000000011000001010001010010000000000101001100010000000010110100000000001000000100
10001010010001101001010100000100000100010100000000000100101100111000001001000111011100100001010010100
00000100101110001101100000000010010011010001111000100101001111101010001010000111010010010010011000100
00010000100010100010101000000001000001000010000000001011100010000000000000101001000001110110110010000
10110110001111001010000001011000001010110010011000100001000000000000001010001000000101101110111001001
11000000000010010001000000000000001000000100000101100100001001110000010110000100000001000000111010000
00001010101110110101110001000000001000001110000011100011011010001001000101000100000000000100011000111
00001100001000000100011100011000100110111111110000010000000001001000011000000110000110011101011010010
01000010000101110001100000000010100000000111111010000000101001001000011100010100011000100000000011010
00110010011111111001000010000001110000101011111000000000010100010100111010010000100000000001000010000
11111100110001100001001001000100011000000001111010001000000100110001100011011110000010100001010100000
11110101000001100000010011110000110011000010101110001000000001010011110000010100111000010010010010111
11100000000100100000110001001000000100100000000010100100000000000001100010100010010010100000000000001
11100000000000100100000001010000010000001011100001100111000111000100000010010000000100001001000110000
00000000000001000101100000000101000000000111110000000101010011001000110001010100101000001000110000001
00000111001000000110000000000100010001001000100110001100011010110000000000100000111100100010100010000
10101000100000000000000100001000010001110001000010000110100000110011101000000000111100101110000111000
10000000000000010001110000010001000000001000010100000110001001110100010010110000011100011010100010000
00000000111000000100000000101100000000001000111000101100000000100010011010101100111110010001100001110
10000110001100000010000001000101110000001010000111001000010000111001001010100001110101010100000000100
11010000101000000100100000001001010000101011001111100010100000000100010000011011100100110000110001100
11000100001000000111000001101100010000100000010101110010000001001000011000100111100100001101100101110
10000110010001000000000000000100100001110100100000010000110010001000000010010111010000001111000000000
00001000000000011000000101000100010101010000001101000110000011000101001010100111000110011110011010001
01100111011010000001000000010100111001001000100100101100000100011101001010110001110000100000011001100
11000101000010000001110001001011011111101001000011100101000001101000101010100100001001001001000000000
01001000000000000011111000100001000000001111100010001000110011100001010110000101000010000001111011001
00000000000110000000000001000001000000111000010011100000100000000100000011000000110011000000101000000
10101010101110001000100010000100000001000000000011101001110010101110111000001000001000100001000010000
00000001000110000001101001000000000010000110000100000000000000000111000000100101010000000011100101010
00110010000000110000000000010101000000000001000100001011000000010000001100000100000100100110000000000
01100111001010100000000100000110011011001100100110101000100010000001010010001110000000001101101000010
00111111001000010011100001000000000100110001000011010001000000000000011001000010101100000000010110100
00010010010001000000010100100001000010000010011100000000000001000010100011001111100100001001010000000
00000100111100000010110000000011000001001100000001100010110100101000000001000000010000001100101001100
00001110011110000011111100000111100100000010010000110100001000010000000000000010100011000001000000000
01101111000011001001111100010011100010000110100010011000000000011010110001010001000110010100101100110
01010100101010111100110000011000001011000100100001101010010000111010100010011001110110010010100000000
01000000011100001100010100100001110001100000001000100000010100011000110000001000010001110101000010000
01000100001001100110000100000110000001000000000011001000000010101000010000011100100000110000100110101
00100100110100100001000101100000110100010101100111001000010000001000001010111001000001100100010000001
01000100000000000000001111011100100101011000001010100100000110100100110000110000000000100100111000000
00011000110001011000010111001111100101101010100000010010001110000110000010100000000100000000011000000
01101110100010000000000000000100000000000000111111110010111010001000000000011001000101101011100000011
00000001100100000011000000000110000100000100100110000000011011000010100010111000001110100110000101000
10111011101000110000010000010000000110111111000000100010000000001001001000010010011110101001100110000
00000011110001000000100100000101000011100010000010000000110010100100100000001100011110000001001010101
10000111111000100000000000000101110001100000110110000110010101000100001001001000111101000000000010000
01001111110010100010100010000101100011000000000001001000100001010001101000010000100000100110000110000
00001111110001110100100011011000111000001011000000000000110001101010000010001000100100101001001000001
01101111110011110011101000111100100000001000000010001000010110001000100010010000001010001000101000000
10101111100001101000001000111110001100001000000010110001000000100000010000010101100000000001000001010
00000111111000001110010010011111101000101000110000000000001001000100111011001100000010001000100100000
10001100000100100000000000001110000001000110101100000000001100101100010100100011001010000101100111010
11111000010110001011011100001110110010010100001100001101100000100001010010001001011000000010000001010
11110001001111100000100010001111110000000110011110100001000010001000100100011010011100001110100000100
11111100111100000010001111000011111000100001001100111100100001100001010010011000001000100111110011111
11111100011000000000001010001100100000000001001001111000001000001011000100010000101101100011000001100
11110010000011010010100000011100100000101010100001000001010000000101010011001111100000000000000000110
01000010000100010100101010110000011000100000010000000010000000000001000000000000100001100000010100010
00011000001111000000100010101010000001110011010000001000101010001000000010100011010011110000010000000
00100010000000000011101000101000000000000000001000001000011101000100000001000000001011111110011001100
00010000100110000010000110100000010010000010011010000000101100001010000011000000110010000100111010000
01000001101011100110000010110001001111100110111101110011001100110000101000000100100100000001101010000
10000000101010001101010000000010000110000101111000100011000000111100000001000010101110101100000110001
11000001100000100000100110000010111110000001111000001100000101001001001000001001011111100101001000001
11110011100000011000100000010000000001010001111110010001110000010010010010001000011111110110000101000
11100001001001111011101100010100000100000100111110100000000000001100000110001000111111100111010000000
