01011110010000000000001010000100000000011100000001000011111000000011111000100000011111110100000000011
00001100010000101000101000010010001101001010000100000001110000010000110000000001010011110000000110011
00100010000000010000100100111000000000100000011000000111001101010000001000100011100000000000110000111
10000001000010010001001001100000100010011000011101010010000000100001000001010000000000001000001100111
00000001000110010000011000000010001100000100111011010110101100000101000100000100101100000000001000011
01100000000000011001001000001100100011010000011000101000101000000001100100001000111010110000100100001
01001000011000011000011000001000101011000101000100001000111100100000000000000100000011000001100000101
00101000000000001010100000000100011000000001000110010100011000100010000100000001000100110001001110000
10000000001000100001000011100010001010110100011110100000001010011000100100000101100000111110000100100
10000001000100000011010001111100000001000000000110001000000001010000010000100111110101001000000100011
11001001010000000100100101111001100100000000011000100010101001000100000001000111100001001010001000111
11001011000001101100100011110000000101001111100011001010000000100100101000100101010100000001000001101
11101011000100110001000000100100010000100000011001100001000100000100101000011100001010010000000010000
11101010100010110011000111000001001000000001001011000010001011010100011000000100001010000010000000110
11100000000001000001111000011010000001101110010010001001000000001000110000001001010000001111111001000
11110010001101000011110010001000000000010110001001101000100110000100001000001001100000000010101010001
11110000010100000001100000111000000011000000001000010100101100000100000100110000010000000000000101100
11100011110110010010101000001001110100100101001010000000100101000110000010001000001001110000101000000
11110111110010111000110010000011000010001100001000000110000011000000100001001001100100100000111100000
10001001100010110011110111010100100000001000100000011010000000010100000010100000000100100011111100000
10010000010001001000011110000010001000000000000010011011010000010000000010001100000100000011111000100
00000001110000000010110100011000000110100000101100000010110100100100001001011100000011110001110000001
01010111111100000001000000000000010000000100001101110010000101011100000010111111010001101011100000001
01000011111000100110000000001000110101011101010000000000000000000000001000011111100100000101001010111
00000001110000000100000000001101000011000111101000000001000010001101011000111111110111110000001000111
00001000111000000010111101000100100001011011100100000001000001000110011001111111111000010011110100011
10100001111000100010000100101110000001001000000100100011001100110010001000011111111100110000010100111
00000000011000101000100000000000010000100001100101110100100101110000000000001111111000000110000010001
01010110010011101110010101000011000000100010000111111100001111001110001010000101111110000001010111010
10000000001000100101101001000110000001000100101111110000000100011001101110000001111000001011111010100
00000000000000000100001000101110011010000000010110110100100101001000000101110000111001110001010000000
00010000010001101000000000010101000000011010000100000000100100000000101000000000100100000000000101000
00000010000000100011010000100100100000011001000010110001000000000010000100000010000010011000010001110
01000110000100101100000000001001111000000100100000011001111100011000001001010010100000000100000000000
00010010000010001100000001010001000000000001000101110001000001111100000000000000010000001100000100000
01010010010100101011000001001001000000010011000100001000001101001000100011000001110010000001000100100
00001000001110001011001101010000110001010000001000111000000000000000000000000010100011000010001111010
00110001000000000000001101001000000001010010000000110101001101000000011010001100000101001001011000000
00010001001011100110011101000001011101000001100000000011100011001011001011010000000001000000000000000
00010010000010001000111100101000000000100100000001000011000110000000010000011010000010010001000000100
00100011010010100000101110010000001010100000001100000001001000101001000011000000001100101000000001000
00100000000000000010100110100001001100000000000001010110101100000010010000100010000001000110000100010
01010000000001000001000000000001100000000111111110000100010000000111011000000010000010001001001110000
01000000011111100000110000101000000011100101000001000000000111010100000100010000000100000000000111000
10110000010000100010010111101010000000110000000101010000000000000000000000001100011011001010100010001
00001000000000100010000111001000000000100000000000000000000111011101100001100000100000101000110100001
10110010010100100110000111100010011100000001111000000000000011001010000000100000100010000010100101000
10110000110001010000010011000000000100001100001100100000011010000000011100001001110100001100001110000
10001101001001000000100000000100000100011101100101000011100010100001010100000010010011011001001001100
00100000101000100110100010010100000101011000101001100011110000100001000001011000001001110000000000000
01001010100000001100110100011000000011111110010001100001011000101000000010010100101111000000111011110
01011000000101000000011000100001000001010010000111110000000100100011001001000000100011011000000000000
11000001011010000010000011110110010101010100000000000100000010000100001010001001000111000100100000010
01000001010011010100000101100111010011010011101001001000000001001110000011011000000011001001010011000
00000001100000011100100100000011110010000001000100011001100010000000111000010100010010010011000011000
01100010000011100000010001000111000000001001001000011100101011100001110000100100000110001000010100001
00000010000110110001001010000000001001000100011110000000010111100001000001000110011010001000000000100
00000000000000001100010100000000001101000010110000000010100101000010000110001110111000000000001000000
11000001001000010000010000110110000000000011001000000010001000101000001110000011100010001100100000001
11100011110100000000000100000001000000010001010001000000000000100100111110100001000000000000000011011
10000001000000110101101000001000000010010101000100000100110011001001111010010100000000011010011000011
10000001101100001011010011000011110000111101011001011000000101001001110000000111010101000100101000011
11110001011110000000010011000010000000010000101000100000000000100011100010011111111010000001000000001
11110000001110000011000010001010010000010011100011110000000111000000101001101001110000010101100010100
00111000000101001010001000000000100000110001010011111000000111000000010001100000001011000010101000010
00000010010101000100001000001001000000100100011001010000010110001011010001000000000100100010000011000
00000000100000101001010001100111000010011001000111000001100001000000000000001001000000000000011010000
01001000011000001001010010010110100001100000101000000000000010100001000101101101000100000100101110101
11101101100101000000000001000000010010011011101001010011011000101000011100000000010010000110100100101
01001111000000100101101010000101000100101001110000010001011101000010010000001100000001001000001100000
01100000000011000001000001111000000001000000111000000010011000000101000100000101101011001100000000001
00001100010010100111100001001000000000010001000110001101111100100100000000000000001000000010001000001
00001111000100100100001000000111001011000101000000000000001000000001010001111000011100001110100000011
00010010111000111000100011001001000100000001000001000011100010010010110010000010001000000001000001111
00111000000000001011100000000000000100010001010001100000000100001000000110110100010000000000110001011
10100101001111011111010000001000100110000100000110010001100001000000010100110000010010001000001000001
10000100000100001001000011001011111000101110110110010000000110010001011100001000101000100100010000010
00100100110100000000000110001000111100000100010000000100001110000001010000010000000000100011000100000
00001100000111001000100010100010111000010110100101101001100001000010001010101010001100010100001100000
00100001100001000100000001110100011111010001101001011000001000000000100011000001001111001110100000011
10100100101000001100010011100110011100100011001010011010000100010000100000101001000111011101000011111
00010110100110101100010000101010001101100001100110111010011111110110111100001001110000011000000001111
01100001000010001000100000100001000100000000001100111000110111110001000001000001100011010010000001111
00000110001000000001011000010111000010000110010101111001100100100100010001010000000000000100011100111
00100010010000010100010101100111101010101101000000100100100100000010010110000111001000010001100000111
00000100000001001110000111000101001000000100010000010011010000000111001110001000000000110001000110110
00101010001001000111001000000000100000110101110110000010000000001111000111000110001010101000000100100
11010000100001000000110000100101000100000000001000110101010101111010101100000011000110000100101000100
00000100000010000000000001010001010100100100100001111001000110100000010000100000000101100001001000001
10010010100010001000100100000001100000010000010000110000001000100010100100010010110000100000001001100
00000000010010000001000000000001000100001010001010001101011010110000100000011011000010010110011010000
10010010000000100100000000001000000100000011011110001000010001110000010101000011101100000010110100001
00000011101001011011100100010000111101010110111100000000011001000000100100100011001001001000000100100
01000011000101010010001110000010000100110010000100000100001000000000110110001000110000100000000100000
00111000010010010000100100011000010000010001001001000000001000000100101001100000111100001100000010000
00000100000000100010001010000110000011000100010011011001000000000001000010101010010000111110100000010
11000001011000010111000000101000000010001001010111000100000000011000110010011110001010001111110000100
00000110100101000101010000001001110010001000010010000000001110010111000000110000000010001111111010110
00110000000111001001100001011000001111111000000110001100010000000000011000010110001001000100100010000
00001100011111100000001001000000110110010111000000000000011011010101001000110000101010000001000000001
00011100111111000111001010010000000000100000000000000010000000001111100100110001001011000111101001111
