11000011000000011100000000000111111010000000000000001101111111111001111111000000100001000001111000100
01100011111000101110000000101111111000000001010000000100111111110001111111100011000000001000110000001
00101000000110001110101100111111110011100000101010101110001111100010111111001110110000000110000001100
00100100001100011100011110011111110100001010000000000100110110010100111111001000010100110101100010111
00000101000000101001001101111111000010001101100000000000000101000001111010011101000110010001010000011
00011100001101000000010000101100101010000000001000110000101001000000010010001101010000100000010011111
00000110000100000000010001000101000000111010000000000010001100010000000000000001010101000110000001010
00001100010001010000000000010001000100001000000000010000000000011001001000000110010001100100100001000
00000010001000010001000000001000000010010010001110000101110001000000000100011000011110001010110001011
00000001000001000010010101000110011000011110110011000000001010000001000001000100011000001001110000000
00000000111000101011100000011110000011000110000000000000001000001011001000010001000000001100100101000
00100000010100001000000100001000100010001110000100000000011010101111100001010010010010000010001001000
00010001000101111010010011001001100001001101001000000001000100100111101000000001001000010000001110101
10010101100000100100000001110000111111000100000001101100100110100001001100001110000001000100100000000
11000000101010000000000101000000010110001100010000000000000000000000010100000100101001000001100000001
11110010110001000000001010100011000010000100000000001100010001010110000110011110100001010100001000111
11110010000100010111000000000000000000110000000001100011000100011010011010001000110010000010000000011
11110100000010100001000010000000100111111000010010110111000010000010111011000000010000110010000000000
11100001100000001010010011100000000000111100000010100001001011000001110000000000011000101100101100100
11000101110111100100100011000000000010001100100000000000010000001001001111010001000001000011100100000
11110011111001000000010011000100001010000000010001001110000000101010010101100001010100010100000000010
11000001110100100101000010000100110000000110110101100101001000101000000100110000111101000001000100100
10000000000001000000000101000000010010000100001101000000100111110001000010000011000010100001010000010
10000110001000000100100000100110100010110101100000111000010000000010110000110000000110000000101100100
00000010000001000110000110010011000000000001000010101001010000000010100110101001000010000000001000011
00010010010000001000000000010110000000010000000010000011110000000000000010000011101110100000000100011
10100000010000100000001000111010000110010100000001000001100101100001001101000001000010000000001101001
11001000110001001010101101110000010001000001001110101001100110001000000000100000101001011001001000011
11100100010000000100000001110000001010010100001100000001000000001000010011000100010100010010000000000
11100101011000000100000011100000000010001100011100000010010000100001111101001001100001001000001010100
01111000000001010001000100000110010000101000011100100100100100011100001000010000000111010001101100111
01110100100100101000100000001100000010100111111100010000011000011110000010100100100000001011100101000
00100000101100000010000010001000010000000000010000000101010001000001100000010000100001000000010100000
00101000000000101000000000000100001001100100011000101000110001000000011000011010001000100000000101010
00100011100010100000000000000001000101001001010010010010010011001100010010001110001001001100000000100
01000011000001111001011000010000100100100000000010010001000000110010100100010000100000100001000100100
00000000001001010000000000011100011101110110000000001010001001010100101000111100001100000010001110000
00000000000011000000000001000100000010100000000000100001010010000001010000000000011000010001000110001
10011000010100111011100101010000100100011100000110011011010000110111000010000000000000000011101100100
00100000000000000000101000000100010010000110010110000001100100000010010100000000000100110001001001000
00110101001000000000000000110000100110000000000000000000011000010000001111010010011010001000000001010
00000000000000000011000110001001001110100010011100001010100010100010100110010111101000000010000000111
11110001001110001000010010010000110110011010111110100100110111000111000011000010001001100001000000111
00000100000100000000110101111101110010111101111111000000000111100001100000001000100100010100000100111
11011101000000000001000000111000100000010001111111001001100011110001011010000101101011010010001110111
00000000000001000010010000000000111010010000111111110001000000100010010010011001000011100100010000000
00011000100001010110100101000000000001001100011111000101101110100110000100111001100011110000011100000
01010010001000000000000011100010100011010100000111110100010111100100100011010100010111110001000000001
00010000110010100000110101100111100000000010101111110110000010010000000010000101011111100000000011000
10010101000101110000100000110000000000110011101111101010011100100100100110000010000110001001000010000
00001001010100000011000000000000001000001101101111000011010100100110001110100000000100000101000110100
11000001000000010111000010101001001000000100000111100000000000000110000100001111000010100000000010001
11000000000011000000000001000000001101001000000111000000000100001100001000000100000000011101000001101
10000000100100011000001011000000000100001110001111100001111011101100000010001000001100001001001000101
11110000101111001000010100000000010010000010110010010000000010001000001000010110110011001100110110100
11000001001100000011010001111010010010100000010000010001010000101110100000000000000010000101100100000
11101010010000011000101001100100000011000010100001000011000000010001000010010110101000001000000001000
11000000000100001101000100010011001111111000000100000000000100111100100010000100010100010010001000001
11100100110100010100010000110000101111110001000000101010110000010001011100000000000001000110100000001
11111100110001100111001000100000110011001000011011001001100100000000000100000110101000100010000000100
11111111111010000001011110010101000111000011000110000000000100000010100000001010000000111010000000000
11111111110000100100111000000100000101010111001101010010011000001111000000010010001100001100101000110
11111011111000100000011001000000011101011011010001001001000000101010101010110110100000000000010001001
11111011011000010010000000000010000100000010000100001000010100111000001110000111010001000101010001010
11111001010100001000101100011000100101110011010000001000000011000000000000100000001000011101110011000
11111001010100000001100000100000000000011000000110010110100111000000000000001100100010100010110000010
11111100010001010100011100110010000100010111000000000100000010000010000001000101010100001000100100001
11111010010000111000100010100000000011010111111110011101000100010001001000000100011000011000100100100
00011001000011101110000000000101001001000001100010000100000010001000000001110001100100011001000100110
01000000000011100000000100010001001100100100101001000000000110001010001111100000010101000011010000111
01010010000010000110100000000000101011111001100110000010000100001000010000101000000100001000010000001
01000000000110010010101110011100100000101010001001000000000101000011100100100010110000011000110000000
10000000111000001001000000000000000010000000000010100011000001010100001100000100010100100000000000000
11011010100000011011001010001001001011001100001100000100001001010010000011100110010100110010101100000
11100000101100001010000000110110010111000111110110000010000100001100000101010111000100100011001000000
11010000000111101000010100000000000000001001000000100010111011001101000000001010100100010011010001111
11000100001011101010000000011000000111111000011000000100001000001000100000000000000100100011100011111
10010000001010101000011010010011001001000000100000110110000100110000010000010001011001000000000011111
10100010000010110000001100100010000000000010001100000100001111000000000001000000000000101011111110111
00000000010000001000010010000100001100000001101001000010011100000000000100000101100010100000011110101
10100111010010001000000000100000011111100000101001010000010000000010001000000000101001110100100110100
00000011101000000001000011000100010000100001111010111110000000011100100100100101010001111000000000000
11100010000000101001000110000001101000110001111000111110000111110100010100001110001100110000011010100
00000000100000000011100001100000001001000000000000101101100000000111010101100110001110111001100100100
01010101100100000111100001000001000100010010010100001001110000000001111000001100100010000000101000110
11011000101110110001110001000001011001100001000000001001011100000000000010011101100010000100000011100
10010100000110101001111110000000010001110101010001101100000000111001000100011001011001000000010000110
11100010000011100000111010000100001001101011001000100100110010000010101111101010000000000001000110001
11000000001000000100110010000000000101000011000000100000000011100000111111000000000101100101000100001
00001110111100010100100000110010001110000010010010000000100001000100100011011011000000010011101000001
00001110000000010000100001110000110010110000000001000000011110010100001000110000010001010011000001111
01000000100001010000100010010000011001100001101000100100010000001100100000100010010100000011100001110
11100001100110000000000000100001000100001111110010110010000111000000100010000000001101001001001100000
11100000100111000001000110000010000000011000100001111011000010000100001100000000001000010010000000000
11100010000000011000010100000111111001000010001011111000000100001100010011100110010100110000101110000
10011100000100111010100000100001110001000001010001110000011001000000000100001000000001100000000011001
00000110010001100000000000000100101100010000000001110101110010100100000011110110001000110010000110000
01100000110100010100000001010100000101011110010100000000000000100111001000100101001001001000000000000
10000001110010001001010010000000000000001110001110101100001011110000101001000000001010100101100100110
00001011110111010001000010110010000100001100010111000010101111110000011000100000100000000000000000000
10111111111111000000100011000001010011101001000011000000001111111000011100000111000000101000001100000
