00001101001011111111000001111111111111101001101100010001100101100100001010100101110100011111001011111
00100001100011111110010001111111111111000000000000011001100001101010001000001001100001010100010011111
10001000100011110000101110111101111111011001100000100010001000001000010010110000010000000100001000101
00000010010001000001000000011101111110001011110101000011100100000100010111011000000001110000000010001
01101011000011100010000001001000111000010011111000000100000001001000000010010000110111100000000100000
11111100000001000000010001000001110110000111110000001100110011101000001000110101001110001100000100000
11100000111001101010001110000100100100000101111010001100010011100010000000001101001111000000100100010
11011000100000111100010100110000100000100000101000000001000001100010100001010110000010000001001110111
11001000000000010000000010000000000010001011000000010100000001000111010011100101010000100000011100000
11101100000010000011001010100010101000100100011111111000110001000000000001001000000000000110001111011
01000000000001000100000100000000001000000001000001110010111001100011110010001100000001100000001101000
00010000001100011100100100101010010010100100101000001000000000000000001010000000010000000000100000000
10000000000011000000011011001001110000100000010001011101100001001010000001011101100101110001110000000
11001000000000100101010000100011101001101110001000000010001000001000000101110000001000010100011100010
11100000011011100011110101111111100011100000100000000000101000110001011000101000001000001101000000000
11000010000111100000000111100000001000000001000100101111000101100000000000001100011000100000011000000
10001000000001000000101100101101000000001100000001001111000010100010010101111000010010110100100000000
10100101001001011101000000001010100100001110010010000100001100011100000011000010000100001000000011000
10000000011100000101000101001000001010100101000100000000011011010001000011100001110000100001001100001
11100100001000101110110010000000111000000000111000000110111011000000010000110000001000100100011001001
00000111010000010110101100000001110000010001110001000101111000000000010000100000001100000100000001001
00010011100001000000000101010100001100101011110001001000000000010000101000000110001010010010010010111
00000001100001000100100000000010110001000001000100110100001000000010000110101000110000000110100000011
00000100101000010000100000000000001000111100000000100000000100001010010011010001000100000000000010100
00010110000010010000010000001000011100111011011011001000010000000100100000000000100010010010100010001
00110110010011010110010000000111001000111000011010010000100100100111000100000010010110110011101000010
00010000101000001101011110000111000000000001010010001011000000100110000010100000011000101100000001000
00000011000000011000100000111100000011001000100001000000101010100100000010000010000010000000000001010
00000110010001000010010101001010010000000111010100000000000000000100000000111011000000001000001101111
00001100000100010000000110001010000000000000010000100101010000100000010011111010000000001000010000111
01100000100010010010000100001000101011100000101001111001100000100000000001010111011100010100000000111
00100000110100111010000000111111001001011001000110110000111110100000100110000001110100000001000100011
10000000010001110000000000000000001100010000010110000110100000001001001000100101100000000001100110011
00010000000000100010000000100010000010100000001000001100010001001010010011101111101101001100000000000
00101000000001000110001001100010001011010000010000010000100100110000100000000001110011000000000100001
10000100100100011111100000001111101100001100001000000000110101010000010001001100100100000011000001010
01001001000010101100000000000010001000011110000000011010100000001100001011001001100100000000000000100
01000000110100000000110110001000000011001100101010001010000000000101000010010000100011110010000100100
00110000000100000000001000000010100000100000000010011001000000000001001011010001110000011010000010000
01001110110010101000000100000000001000110000100010000011101010100110001111100100100001100010010001010
00000111001100010001000000111100100010000001001010101001000010100000011111111001100001110110101100000
00001111101000111101001000000000000101001101101011110000001000010110001011111000000011100010100000001
10001001000010100000011110101100000000001000000010101111000010000100000001000011100000001010000010010
00100001000100000101111110001100100110111011111000000100000100000000000000010101110010010000010010010
00100000111000010011111101100110001110110000000000101000010100001000011001010000100000111100001000000
00010010001001010011111101000000000111111010000000010000111000011000000111100001100010100000000110001
00001001011010000011011001000000000000111000011000100001111111000110011001111101010000100001001100100
00100001000010010100000001101000001000011110001000000000111101010100010000110000001000000100101000100
01000010011000100000000100000010000010001010100010111111001100100000000001000000000000000010000010000
01010000100000010110000001100010110000000000010111001100000000100000001000101000100000100100101000001
11100000100000000001010101111001111000001101100010000100101010101110110100000000100010010010010001000
10001000010101001000000000100001110001000100000100010100001000000011110001001100000001010000001000010
10000001001011100000001001100010000010010000001000001010100000001110010011110000001000011100000100000
00100110011011100000001010001011000111010100001000111000010001100010000001010000100000011001000000000
00001111001001000110001001010000100101000100000110010010101001001100001010010000100010100000100101010
10110110000001100100100101100100011101010001000100000000000011000000011100000000010000110000101000000
00000001001000100000010100010010001101001000100000011000000000110100111000011000011010100001110100100
00000100000001001010000111111011001100010001100000100101001010000100011100000010110000100000100101010
00000100001000100000100001111000110000100101100100110011010001001101001000001001000000100000010101000
00000000000000110001100100010010100001010000000000010000010000011000110010001000100100110001000001100
00101000001101111001000000111000010010000100001010000100000000001000110010011100001010110100000000100
10000110011111100011000011000010110010001010001000000100000011011100001000011010111001100001100000101
00000000001101100100100110011001111010110000001000100100001111110011001000101011111000100100001010000
00100101010001100010000111000111110000010001010000110010011111000010001010000001111000010100000000001
00010010011000100100010110000001111000101001100010000000000110010010001001110010111100101110100100001
01001111010010100100010100000100000000000000000111110001000000110000101000000010011100000100100001000
01111111101000000011000001001100101001100001000100001000001000000100011001100000001001111000101001001
00111111100000000001110001101010111100000001110000001000110000000010011010000100000000000001001000011
00011111010000000110001001000000001000100000110000011100111000000000100010100001011010110000000000001
01111111000101000000000000000000100000101000000000001101000000000001000100010000001010110000001000101
01111100010100010000011011101100000110110010010001100100110001001000101110000001000000001100111110000
00111000000010110011110000100000100100000001000011000101111000001100100010000011010000000000111100000
10110000000001110011101000000000100100000010000110001101110011011100101000000001100001100011011010010
10001011000010100001000000001000010010001010000000010001010110011110111010101111111010011000001000000
00101000001100000000000101000110100000001001100000001000010110001110011110001111100000010000100100010
00001110100000001001000011111101110111011010000011001010000100111100101001000111010010011100000000000
10000001000010100000010011011100000111000000110000000100000010010101001000001100011101000101011011000
01000000010001000000100100000010100010011000101001100011001001100000100110001010111000000010100100010
00000111000000001000000000100101011000000011000000000001011001110000000000000010111010101100000001100
01000100011010000010101101000000011100011000000010001101001111100000100010001110111010011000010110010
01000001001010000010000001000000001000100000010110100110010000000000010010101000001100000110111000001
00010001000001001010000111010000110001000001100000000111000001010100001110001011000001000000010000011
00000100110100101100000000010000011000100011110010000010000001000000000100011011000001001111000000011
00001001100100000000100000000000000000010001000010000000101000100000000010001100010000000100000110000
00100000100100001110000000110001100000000100001000110101110011000111100000000101010001000111010100000
01000000001000000000010001110001110100100101110100100100110000000001101000101000101010000110010000101
00100000111010000110101110100000010101000001010000110111101000000000000010001100100000100000010001000
00100000010010000001100000000000111000001010010000010001000010111010000110000111100100000000011100000
10000000110000100000000000000001011100111000111001100000011000010100000111101110000001001000010000111
00100001111010010000010010010001000010101001111101100001001000000000000011101000000100000000100000011
01100000000000000011000000100000000000000001100001001100000000110000100111010010100100101000110001011
10010001000001101000101110001011000101000010000000000110000100000101100111000010010100001110010010000
00100001100110100000000110001010000110000011000110000010000000000000010001001100001010101010110111000
00001010001000100001100010000000010000100100000010001000000000001010000011000000101001001001001011000
00011001100010100000010101010001100000000000001001000000000000110000001101000000010001101000000010001
00110001110001100011001000111000110010010001000000000000101001000001000001000000010001111000000000001
00011100001100111001001000001000100000000010001000000000000110001100000100101010000001100110100010101
00001110011100010001010001010110000100111100000010000101000100000100000110000000100000010000000101111
00000100011000111101000101110001010010000010011001010000001000001000000000101111001101001110100001100
01000100000100010000101111110000000111011101001011100011110100000000110101110000000110000001110000000
00101001011100010010100111111000001111010000000011110000000000100010001100100000100010100100010001000
