00001010000111000110000011001000000000100011000110000100110000000010100000000100110000101001111111111
10010010110000000000001111011001001000100000001000100001110001000000011011000000101001101001111111111
00000111000100000100110000000001000000100000001011110111111000001100000111000000000010000101111111111
10000001100000000110111101000011001100010001011011101001111000111000010000001100100000000000111111111
10100101100101001010010011010110001000000100011000000011111000000001100100100000000101000000011111111
00000000000000010010001000010000111101100000000000001011110000100010000001101100001010011111001111111
00000000110000010000100001000111111100000000010101000001111110001010000000001010001001110100000011111
00101100001010000100000000000111111111000000100000100111111100000110100000010000010100000001000111111
00011100000000110010000000011111111110100000010111111111111111110010101001001001000000110000000111101
00001001100000100001000000000111111110000101000111111111111100000010110100111000000001001000000001000
10100000100000000000000001101111111111110001000111111000111000001001100000000000000000010010000000000
00010000101010001000000000011001111111110100000011111100010000011010001101101000000100010110100000001
01000000011011110000101000001001111111110010110011111100000000011100100110101001000101000100110010111
00001000011111110000001101001001110011000000000111111100100001000000001100111110010011010010001110001
10000101010111100001010110100010101000101010000001111000100101010010001010111011100010001100011111001
00010000000000000101000000110010000011111001100001111111001100000000000000010000101000100010111000110
01000101000101000001000001001011100000000000111000111000000110010010010101010100010000000110011110000
00000100101000001100100100001100010110001110110010000101000000000100001000010010010111000000011110010
00111100000100001011100000000100011000011000000000010000000100010000001000010000100100000100111100010
01010011001000000000000010001000010001001000011001101000000000001001000110010000001010000100001000000
01010100100100001010010100001001000010000000010000000110010000000010000000000100010000000001000001000
01000100101000100111001100000000100001001000010100100000101001000000001010000100100100010000010100000
11000100001000000110110001100101010000000101001100110010000010001000001000000000100001000100000000001
00101001001010011010001001011100001000000001100100011000000100110011010100101100000000001100001001001
00100000010001001000011110000010000000111110000001111000100000000010010100000010010000001001000000000
00000001111001000001001010100000000010001000110100111010010000010011000110000000100000001001000010010
01000100001000000010110000111010000000000001110110110001000011000111000010001000101011111111000010000
00010000011000000000000010010101010000000000010000000010010110001001000001111010010010010111000010100
00010000110001000110010100100000001000100101000011010000101110100001110001010000000000010111110000011
10100010101000001100001110000000010001100001010101000000000110000010000000010000100100010011100000010
10110111001001110001001000100001000001000000010100010000010000001001001011100001000001000001000001000
00100010000101000011111100000001001010001010000111010010110000011000101000001100101110010100010111101
11111000011001110101111100000010001000010010100000000000100000101111000000000001100010000000000001000
11010100000110110100111001000000000111110110100001100011001010001100010000101001000110000010000100100
11000010000100000101000000001011000001010101000000110001000110000001000001010000000001001001010000000
11000010001100010000100101000010000100000000001111000001000100000000001100000000010000100100000101000
11110000000100111100000010000101000010100111000000100000100011000100110101000000110010100101000000010
00100000110100000111000000101001000000000111000000001001000000010000000100010001000011000001001000001
00000101010010000001000100100010001011001111100010000001001100001011001010111001000001100110001010100
10000100010001111010101100001010010001001101000010000110011000100000010011010001100011101111000011000
00110001101100001100000110101010000010001001100011000110011010001101010100000100101011000001100100010
01000011100111100000000010010000010111011000100000001011011111000010000100010100000000011001000100011
00011111100000001110000110011101001110000100001111110000010000010100000000110010001010000101001010111
00011111001010000010000000011100000100000001000010000001010101000000000100000000000100000001000010010
10000111010100100100000101001000011000100110010010000001100101010011000010001000001000111100010101000
10001111110010000001101100000010100000010111000001110001001000010000001000000001100100000100010000100
00011111110000101000001101001100011000100010100110000001010000100100100100011100001101100000000010001
00011111110000001110011110010000000110001000001000100000011011001100011000010000001000000000010000010
00011111101101000000010010001001100100010000000001000000000000010001100010010100000001010000010111000
01111111100000111010000000000000110000010010010110000000110010110000010100010100000000011000000010011
01001110011100011100011101101101000010001000100000001000000100110000000100000100110110001010111000011
11000010111010001101011100110001000100000001000000011000001000001010110111000011100000101001010011001
00010000010001001101100100111000101001000011110000010000000100000111110000111010000000001010010000011
00110100000001010001001101011110010010010101000100010000001010000000100000000001000001101000100100001
10000000000111110100001111000000000010000001101110100001000000100001010011000000001101110001111000110
00100011010010001000001110110000100010000100000110010000100000110100000001000000000110010100101101000
00000000001000001110000110000011110000000000100000000101000000000010100101100000101110010000000010010
01100110001001010010001001110001101000011100000001000010000100100000001010000000111100001001100010011
11111011100000000010000000100101000101000001000011011000000111101011010000001100011110000100100110011
11100000001101000010000101000000001000011001000011000000010111100000010101110101001110010000010010011
11110010010011000111101000001110000100110011000000001000000011010000100010000000000101010000010000001
10100000000010000000101000010001001111000001000110010100100100001001000100110000110001001000010101100
00100010000000000000000000100000001110011010000010000100000101000100010101010000001001000001101000101
01101010000000101000001011001100000100010000000000000000001010000101000101000010010000010000001110001
00000100010001001110100110000100010000000001010000010011001000100101001100111000000000000010000000000
00100001000101011111111000101110000000010111110110011111010000001110010010010001100101111000001000101
00010000100000000111000000000000100000101001001010001100000111110110101000100000100100010001110011100
00110110000100100000000011001000000010001000100000011010000000000000100011110001000010111000101000101
11000010111001100110001100000110000100001000000110100010100000001101000000110001000010000000000000111
11100001000000000110011000100000010111000100000010100001111000100000001001100000001000100010100010111
11110000000001000000000001101000000100011000001000000000100000000000000100010010000001110010100000011
11111010000000110001000010001001000000011110000101100010000000100001001001100000000000100010001000000
11110100011100011001001000011000000000111001000001101100100001010000011101000001110000001010010100000
11100101100001111001000000100000101000011011000100101011000011000100010000111010001001010001000100101
11000001000010010011100010001000000011000011001000000000000000001000110000100000010000000000010000001
10000000000000011011111001110011110100100100100000000010010010000000010000100000001000011000000001010
10010001000001000011111000010011000000100010101010000001100001000010101100111110001000111000110101000
11000100001000011011111101011001000001001000011100000100000101001001000010010000001000010100110011000
10010001000001011101011000000110000000000011010000001000000000011101000110000101100110000000010100000
00010101011101001000000100000100100000010000000111000100100011001001001100000000001001010000100000010
00001001100011100010100110000000100010010000000101000100001000001010010001000100000100001010000010110
01010100100111000001110111000101000000000010100000110000000000010000100001001001000000001010110100110
00000110001111000010010010000001101000010000100000100000000100000111110000000100010010100001000101000
10100000010010001000000000010100001011100000000000001011001000110011100001000010010100100000010001010
00100011000101000111110010110100010100001001000000100111000100000000000000001111010000000100001000000
00100000011000000101001001101000100000100001010100000011101001101010110000000000110101100001000001000
00110000011010000100001101001001100000110000001100100100001101000000010101001000001011110110010110100
00000011000111001000011100100010001000110011000000000101001000000000000000010110000010100010000000010
01000000001001000001000010000100100000101010100010000101010011101001010000010000010000010011000000010
01000000010000000010000111001001111111000000001100000011010000000000010000110100001000010000000001000
10000011000010010010111011011110111111100010010000100111001010000100111011000001000001001010010000000
00001100000010010001000010001100111111000010001010000100000000100100100000010010001111001100010100001
00000100000110111101001001000000011010010010100010000001010000101001000001100011010111000000111000011
00010100000010011110010000100001000001011100010000000000000110000000011011111000010011000000010001111
00011000101010011110000000000000001000000000110000000101110010010010101111100100000010001000100110001
01110000000110111110100000000011100010000001110000101100110000100000000100000100110100001000101000111
00010000100000011111000110000000001010101000000000000101010010000100001111001000001001000110010000000
00001010101001011111100000001100001010011010001111000011010011011000000000001001001000000000000000010
10000000000000111011000000011010000010000101110000101010001010011100010110000000011100000000001010000
00000001010101000001000000000010010100010001100101000000100011101000010000111000010100010000011101000
01000001000000000010010010000000111110010001001000000000100000000000001010110000000010000000111100011
